# FROM-URL	TO-URL
/uk/docs/Glossary/Block/Скриптинг	/uk/docs/Glossary/Block/Scripting
/uk/docs/Glossary/DTD	/uk/docs/conflicting/Glossary/Doctype
/uk/docs/Glossary/Інструкція	/uk/docs/Glossary/Statement
/uk/docs/Glossary/Інтернет	/uk/docs/Glossary/Internet
/uk/docs/Glossary/Абстракція	/uk/docs/Glossary/Abstraction
/uk/docs/Glossary/Алгоритм	/uk/docs/Glossary/Algorithm
/uk/docs/Glossary/Арґумент	/uk/docs/Glossary/Argument
/uk/docs/Glossary/Буфер	/uk/docs/Glossary/buffer
/uk/docs/Glossary/Веб_Доступність	/uk/docs/Glossary/Accessibility
/uk/docs/Glossary/Вікно_перегляду	/uk/docs/Glossary/Viewport
/uk/docs/Glossary/ДК	/uk/docs/Glossary/UX
/uk/docs/Glossary/Дешифрування	/uk/docs/Glossary/Decryption
/uk/docs/Glossary/Динамічна_мова_програмування	/uk/docs/Glossary/Dynamic_programming_language
/uk/docs/Glossary/Замикання	/uk/docs/Glossary/Closure
/uk/docs/Glossary/Змінна	/uk/docs/Glossary/Variable
/uk/docs/Glossary/Значення	/uk/docs/Glossary/Value
/uk/docs/Glossary/Компіляція	/uk/docs/Glossary/Compile
/uk/docs/Glossary/Криптоаналіз	/uk/docs/Glossary/Cryptanalysis
/uk/docs/Glossary/Криптографічна_геш-функція	/uk/docs/Glossary/Cryptographic_hash_function
/uk/docs/Glossary/Криптографія	/uk/docs/Glossary/Cryptography
/uk/docs/Glossary/Метод	/uk/docs/Glossary/Method
/uk/docs/Glossary/ООП	/uk/docs/Glossary/OOP
/uk/docs/Glossary/Обгортка	/uk/docs/Glossary/Wrapper
/uk/docs/Glossary/Оператор	/uk/docs/Glossary/Operator
/uk/docs/Glossary/Посилання	/uk/docs/Glossary/Hyperlink
/uk/docs/Glossary/Рекурсія	/uk/docs/Glossary/Recursion
/uk/docs/Glossary/Символ	/uk/docs/Glossary/Symbol
/uk/docs/Glossary/Тенета	/uk/docs/Glossary/World_Wide_Web
/uk/docs/Glossary/Тип	/uk/docs/Glossary/Type
/uk/docs/Glossary/Функція	/uk/docs/Glossary/Function
/uk/docs/Glossary/Шифр	/uk/docs/Glossary/Cipher
/uk/docs/Glossary/Шифротекст	/uk/docs/Glossary/Ciphertext
/uk/docs/Glossary/ідентифікатор	/uk/docs/Glossary/Identifier
/uk/docs/Learn/CSS/CSS_розмітка	/uk/docs/Learn/CSS/CSS_layout
/uk/docs/Learn/CSS/First_steps/Що_таке_CSS	/uk/docs/Learn/CSS/First_steps/What_is_CSS
/uk/docs/Learn/CSS/Introduction_to_CSS	/en-US/docs/Learn/CSS/First_steps
/uk/docs/Learn/CSS/Styling_text/Стилі_списків	/uk/docs/Learn/CSS/Styling_text/Styling_lists
/uk/docs/Learn/Getting_started_with_the_web/Інтернет_та_веб-стандарти	/uk/docs/Learn/Getting_started_with_the_web/The_web_and_web_standards
/uk/docs/Learn/HTML/Forms	/uk/docs/Learn/Forms
/uk/docs/Learn/HTML/Forms/Your_first_form	/uk/docs/Learn/Forms/Your_first_form
/uk/docs/Learn/HTML/Introduction_to_HTML/scho_v_head_metadani_v_HTML	/uk/docs/Learn/HTML/Introduction_to_HTML/The_head_metadata_in_HTML
/uk/docs/Learn/How_to_contribute	/uk/docs/orphaned/Learn/How_to_contribute
/uk/docs/Learn/JavaScript/Асинхронний	/uk/docs/Learn/JavaScript/Asynchronous
/uk/docs/Learn/JavaScript/Будівельні_блоки	/uk/docs/Learn/JavaScript/Building_blocks
/uk/docs/Learn/Tools_and_testing/Git_та_GitHub	/uk/docs/Learn/Tools_and_testing/GitHub
/uk/docs/Learn/Tools_and_testing/Розуміння_JavaScript-фреймворків_на_стороні_клієнта	/uk/docs/Learn/Tools_and_testing/Client-side_JavaScript_frameworks
/uk/docs/Learn/Tools_and_testing/Розуміння_JavaScript-фреймворків_на_стороні_клієнта/znayomymos_zi_svelte	/uk/docs/Learn/Tools_and_testing/Client-side_JavaScript_frameworks/Svelte_getting_started
/uk/docs/Learn/Tools_and_testing/Розуміння_інструментів_веб-розробки_на_стороні_клієнта	/uk/docs/Learn/Tools_and_testing/Understanding_client-side_tools
/uk/docs/Learn/Tools_and_testing/Тестування_кросбраузерності	/uk/docs/Learn/Tools_and_testing/Cross_browser_testing
/uk/docs/Learn/Доступність	/uk/docs/Learn/Accessibility
/uk/docs/Learn/Навчання_та_отримання_допомоги	/uk/docs/Learn/Learning_and_getting_help
/uk/docs/Learn/Фронт-енд_веб-розробник	/uk/docs/Learn/Front-end_web_developer
/uk/docs/MDN/Community	/uk/docs/orphaned/MDN/Community
/uk/docs/MDN/Contribute/Guidelines	/uk/docs/MDN/Guidelines
/uk/docs/MDN/Contribute/Guidelines/Настанови_зі_стилю	/uk/docs/MDN/Guidelines/Writing_style_guide
/uk/docs/MDN/Contribute/Howto/Create_an_MDN_account	/uk/docs/orphaned/MDN/Contribute/Howto/Create_an_MDN_account
/uk/docs/MDN/Contribute/Howto/Do_an_editorial_review	/uk/docs/orphaned/MDN/Contribute/Howto/Do_an_editorial_review
/uk/docs/MDN/Contribute/Howto/Set_the_summary_for_a_page	/uk/docs/orphaned/MDN/Contribute/Howto/Set_the_summary_for_a_page
/uk/docs/MDN/Contribute/Howto/Бета_тестування	/uk/docs/orphaned/MDN/Contribute/Howto/Be_a_beta_tester
/uk/docs/MDN/Contribute/Howto/Як_створювати_й_редагувати_сторінки	/uk/docs/MDN/Contribute/Howto/Create_and_edit_pages
/uk/docs/MDN/Contribute/Structures	/uk/docs/MDN/Structures
/uk/docs/MDN/Contribute/Structures/Шаблони	/uk/docs/MDN/Structures/Macros
/uk/docs/MDN/Contribute/Structures/Шаблони/Загальновживані_шаблони	/uk/docs/MDN/Structures/Macros/Commonly-used_macros
/uk/docs/MDN/Contribute/Tools	/uk/docs/MDN/Tools
/uk/docs/MDN/Contribute/Tools/KumaScript	/uk/docs/MDN/Tools/KumaScript
/uk/docs/MDN/Contribute/Tools/KumaScript/Усунення_помилок_KumaScript	/uk/docs/MDN/Tools/KumaScript/Troubleshooting
/uk/docs/MDN/Guidelines/Настанови_зі_стилю	/uk/docs/MDN/Guidelines/Writing_style_guide
/uk/docs/MDN/Kuma	/uk/docs/MDN/Yari
/uk/docs/MDN/Structures/Шаблони	/uk/docs/MDN/Structures/Macros
/uk/docs/MDN/Structures/Шаблони/Загальновживані_шаблони	/uk/docs/MDN/Structures/Macros/Commonly-used_macros
/uk/docs/MDN/Tools/KumaScript/Усунення_помилок_KumaScript	/uk/docs/MDN/Tools/KumaScript/Troubleshooting
/uk/docs/MDN/Про	/uk/docs/MDN/About
/uk/docs/MDN/з_чого_почати	/uk/docs/MDN/Contribute/Getting_started
/uk/docs/Mozilla/Add-ons/WebExtensions/Що_таке_Web_Розширення	/uk/docs/Mozilla/Add-ons/WebExtensions/What_are_WebExtensions
/uk/docs/Web/API/API_відображення_сторінки	/uk/docs/Web/API/Page_Visibility_API
/uk/docs/Web/API/Canvas_API/Tutorial/Чутливі_ділянки_та_доступність	/uk/docs/Web/API/Canvas_API/Tutorial/Hit_regions_and_accessibility
/uk/docs/Web/API/WindowTimers	/uk/docs/conflicting/Web/API/WindowOrWorkerGlobalScope
/uk/docs/Web/API/WindowTimers/setTimeout	/uk/docs/Web/API/WindowOrWorkerGlobalScope/setTimeout
/uk/docs/Web/API/Подія	/uk/docs/Web/API/Event
/uk/docs/Web/API/Подія/target	/uk/docs/Web/API/Event/target
/uk/docs/Web/CSS/CSS_Animations/Використання_CSS_анімацій	/uk/docs/Web/CSS/CSS_Animations/Using_CSS_animations
/uk/docs/Web/CSS/CSS_Box_Model/Згортання_відступів	/uk/docs/Web/CSS/CSS_Box_Model/Mastering_margin_collapsing
/uk/docs/Web/CSS/CSS_Flexible_Box_Layout/Using_CSS_flexible_boxes	/uk/docs/Web/CSS/CSS_Flexible_Box_Layout/Basic_Concepts_of_Flexbox
/uk/docs/Web/CSS/attr	/uk/docs/Web/CSS/attr()
/uk/docs/Web/CSS/linear-gradient	/uk/docs/Web/CSS/linear-gradient()
/uk/docs/Web/CSS/Альтернативні_таблиці_стилів	/uk/docs/Web/CSS/Alternative_style_sheets
/uk/docs/Web/CSS/Довідник	/uk/docs/Web/CSS/Reference
/uk/docs/Web/CSS/Коробчаста_модель_CSS	/uk/docs/Web/CSS/CSS_Box_Model
/uk/docs/Web/CSS/Модель_візуального_формування	/uk/docs/Web/CSS/Visual_formatting_model
/uk/docs/Web/CSS/Розмітка_кулінарна-книга	/uk/docs/Web/CSS/Layout_cookbook
/uk/docs/Web/CSS/Схема_компонування	/uk/docs/Web/CSS/Layout_mode
/uk/docs/Web/Events/DOMContentLoaded	/uk/docs/Web/API/Window/DOMContentLoaded_event
/uk/docs/Web/Events/abort	/uk/docs/Web/API/HTMLMediaElement/abort_event
/uk/docs/Web/Guide/CSS	/uk/docs/Learn/CSS
/uk/docs/Web/Guide/CSS/Getting_started	/uk/docs/conflicting/Learn/CSS/First_steps
/uk/docs/Web/Guide/CSS/Getting_started/What_is_CSS	/uk/docs/Learn/CSS/First_steps/How_CSS_works
/uk/docs/Web/Guide/HTML	/uk/docs/Learn/HTML
/uk/docs/Web/Guide/HTML/Використання_HTML-секцій_та_структура_документу	/uk/docs/Web/Guide/HTML/Using_HTML_sections_and_outlines
/uk/docs/Web/Guide/HTML/Вступ	/uk/docs/Learn/HTML/Introduction_to_HTML
/uk/docs/Web/Guide/Графіка	/uk/docs/Web/Guide/Graphics
/uk/docs/Web/HTML/Довідник	/uk/docs/Web/HTML/Reference
/uk/docs/Web/HTML/Елемент	/uk/docs/Web/HTML/Element
/uk/docs/Web/HTML/Елемент/html	/uk/docs/Web/HTML/Element/html
/uk/docs/Web/HTML/Елемент/iframe	/uk/docs/Web/HTML/Element/iframe
/uk/docs/Web/HTML/Елемент/link	/uk/docs/Web/HTML/Element/link
/uk/docs/Web/HTML/Елемент/nav	/uk/docs/Web/HTML/Element/nav
/uk/docs/Web/HTML/Елемент/script	/uk/docs/Web/HTML/Element/script
/uk/docs/Web/HTML/Елемент/section	/uk/docs/Web/HTML/Element/section
/uk/docs/Web/HTML/Елемент/style	/uk/docs/Web/HTML/Element/style
/uk/docs/Web/HTML/Елемент/table	/uk/docs/Web/HTML/Element/table
/uk/docs/Web/HTML/Елемент/video	/uk/docs/Web/HTML/Element/video
/uk/docs/Web/HTML/Елемент/Заголовок	/uk/docs/Web/HTML/Element/header
/uk/docs/Web/HTML/Загальні_атрибути	/uk/docs/Web/HTML/Global_attributes
/uk/docs/Web/HTML/Загальні_атрибути/hidden	/uk/docs/Web/HTML/Global_attributes/hidden
/uk/docs/Web/HTML/Загальні_атрибути/itemscope	/uk/docs/Web/HTML/Global_attributes/itemscope
/uk/docs/Web/HTML/Загальні_атрибути/lang	/uk/docs/Web/HTML/Global_attributes/lang
/uk/docs/Web/HTML/Загальні_атрибути/tabindex	/uk/docs/Web/HTML/Global_attributes/tabindex
/uk/docs/Web/HTML/Режим_сумісності_й_стандартний_режим	/uk/docs/Web/HTML/Quirks_Mode_and_Standards_Mode
/uk/docs/Web/HTTP/Заголовки	/uk/docs/Web/HTTP/Headers
/uk/docs/Web/HTTP/Заголовки/Accept	/uk/docs/Web/HTTP/Headers/Accept
/uk/docs/Web/HTTP/Заголовки/Accept-Encoding	/uk/docs/Web/HTTP/Headers/Accept-Encoding
/uk/docs/Web/HTTP/Заголовки/Accept-Language	/uk/docs/Web/HTTP/Headers/Accept-Language
/uk/docs/Web/HTTP/Заголовки/Connection	/uk/docs/Web/HTTP/Headers/Connection
/uk/docs/Web/HTTP/Заголовки/Content-Length	/uk/docs/Web/HTTP/Headers/Content-Length
/uk/docs/Web/HTTP/Заголовки/Content-Type	/uk/docs/Web/HTTP/Headers/Content-Type
/uk/docs/Web/HTTP/Заголовки/ETag	/uk/docs/Web/HTTP/Headers/ETag
/uk/docs/Web/HTTP/Заголовки/If-Match	/uk/docs/Web/HTTP/Headers/If-Match
/uk/docs/Web/HTTP/Заголовки/Location	/uk/docs/Web/HTTP/Headers/Location
/uk/docs/Web/HTTP/Заголовки/Referer	/uk/docs/Web/HTTP/Headers/Referer
/uk/docs/Web/HTTP/Заголовки/User-Agent	/uk/docs/Web/HTTP/Headers/User-Agent
/uk/docs/Web/HTTP/Заголовки/X-Forwarded-Proto	/uk/docs/Web/HTTP/Headers/X-Forwarded-Proto
/uk/docs/Web/JavaScript/Guide/Dokladno_pro_Objectnu_Model	/uk/docs/Web/JavaScript/Guide/Details_of_the_Object_Model
/uk/docs/Web/JavaScript/Guide/Вирази_та_оператори	/uk/docs/Web/JavaScript/Guide/Expressions_and_Operators
/uk/docs/Web/JavaScript/Reference/Functions/Стрілкові_функції	/uk/docs/Web/JavaScript/Reference/Functions/Arrow_functions
/uk/docs/Web/JavaScript/Reference/Functions/решта_параметрів	/uk/docs/Web/JavaScript/Reference/Functions/rest_parameters
/uk/docs/Web/JavaScript/Reference/Global_Objects/Array/prototype	/uk/docs/orphaned/Web/JavaScript/Reference/Global_Objects/Array/prototype
/uk/docs/Web/JavaScript/Reference/Global_Objects/AsyncFunction/prototype	/uk/docs/orphaned/Web/JavaScript/Reference/Global_Objects/AsyncFunction/prototype
/uk/docs/Web/JavaScript/Reference/Global_Objects/Boolean/prototype	/uk/docs/conflicting/Web/JavaScript/Reference/Global_Objects/Boolean
/uk/docs/Web/JavaScript/Reference/Global_Objects/Date/prototype	/uk/docs/Web/JavaScript/Reference/Global_Objects/Date
/uk/docs/Web/JavaScript/Reference/Global_Objects/Error/prototype	/uk/docs/conflicting/Web/JavaScript/Reference/Global_Objects/Error
/uk/docs/Web/JavaScript/Reference/Global_Objects/EvalError/prototype	/uk/docs/conflicting/Web/JavaScript/Reference/Global_Objects/EvalError
/uk/docs/Web/JavaScript/Reference/Global_Objects/Function/prototype	/uk/docs/conflicting/Web/JavaScript/Reference/Global_Objects/Function
/uk/docs/Web/JavaScript/Reference/Global_Objects/GeneratorFunction/prototype	/uk/docs/conflicting/Web/JavaScript/Reference/Global_Objects/GeneratorFunction
/uk/docs/Web/JavaScript/Reference/Global_Objects/InternalError/prototype	/uk/docs/conflicting/Web/JavaScript/Reference/Global_Objects/InternalError
/uk/docs/Web/JavaScript/Reference/Global_Objects/Math/заокругелння	/uk/docs/Web/JavaScript/Reference/Global_Objects/Math/round
/uk/docs/Web/JavaScript/Reference/Global_Objects/Object/prototype	/uk/docs/Web/JavaScript/Reference/Global_Objects/Object
/uk/docs/Web/JavaScript/Reference/Global_Objects/Promise/prototype	/uk/docs/conflicting/Web/JavaScript/Reference/Global_Objects/Promise
/uk/docs/Web/JavaScript/Reference/Global_Objects/Promise/відхилено	/uk/docs/Web/JavaScript/Reference/Global_Objects/Promise/reject
/uk/docs/Web/JavaScript/Reference/Global_Objects/RangeError/prototype	/uk/docs/conflicting/Web/JavaScript/Reference/Global_Objects/RangeError
/uk/docs/Web/JavaScript/Reference/Global_Objects/ReferenceError/prototype	/uk/docs/conflicting/Web/JavaScript/Reference/Global_Objects/ReferenceError
/uk/docs/Web/JavaScript/Reference/Global_Objects/SyntaxError/prototype	/uk/docs/conflicting/Web/JavaScript/Reference/Global_Objects/SyntaxError
/uk/docs/Web/JavaScript/Reference/Global_Objects/TypeError/prototype	/uk/docs/conflicting/Web/JavaScript/Reference/Global_Objects/TypeError
/uk/docs/Web/JavaScript/Reference/Global_Objects/URIError/prototype	/uk/docs/conflicting/Web/JavaScript/Reference/Global_Objects/URIError
/uk/docs/Web/JavaScript/Reference/Global_Objects/Число	/uk/docs/Web/JavaScript/Reference/Global_Objects/Number
/uk/docs/Web/JavaScript/Reference/Global_Objects/Число/EPSILON	/uk/docs/Web/JavaScript/Reference/Global_Objects/Number/EPSILON
/uk/docs/Web/JavaScript/Reference/Global_Objects/Число/MAX_SAFE_INTEGER	/uk/docs/Web/JavaScript/Reference/Global_Objects/Number/MAX_SAFE_INTEGER
/uk/docs/Web/JavaScript/Reference/Global_Objects/Число/MAX_VALUE	/uk/docs/Web/JavaScript/Reference/Global_Objects/Number/MAX_VALUE
/uk/docs/Web/JavaScript/Reference/Global_Objects/Число/MIN_SAFE_INTEGER	/uk/docs/Web/JavaScript/Reference/Global_Objects/Number/MIN_SAFE_INTEGER
/uk/docs/Web/JavaScript/Reference/Global_Objects/Число/MIN_VALUE	/uk/docs/Web/JavaScript/Reference/Global_Objects/Number/MIN_VALUE
/uk/docs/Web/JavaScript/Reference/Global_Objects/Число/NEGATIVE_INFINITY	/uk/docs/Web/JavaScript/Reference/Global_Objects/Number/NEGATIVE_INFINITY
/uk/docs/Web/JavaScript/Reference/Global_Objects/Число/NaN	/uk/docs/Web/JavaScript/Reference/Global_Objects/Number/NaN
/uk/docs/Web/JavaScript/Reference/Global_Objects/Число/Number	/uk/docs/Web/JavaScript/Reference/Global_Objects/Number/Number
/uk/docs/Web/JavaScript/Reference/Global_Objects/Число/POSITIVE_INFINITY	/uk/docs/Web/JavaScript/Reference/Global_Objects/Number/POSITIVE_INFINITY
/uk/docs/Web/JavaScript/Reference/Global_Objects/Число/isFinite	/uk/docs/Web/JavaScript/Reference/Global_Objects/Number/isFinite
/uk/docs/Web/JavaScript/Reference/Global_Objects/Число/isInteger	/uk/docs/Web/JavaScript/Reference/Global_Objects/Number/isInteger
/uk/docs/Web/JavaScript/Reference/Global_Objects/Число/isNaN	/uk/docs/Web/JavaScript/Reference/Global_Objects/Number/isNaN
/uk/docs/Web/JavaScript/Reference/Global_Objects/Число/isSafeInteger	/uk/docs/Web/JavaScript/Reference/Global_Objects/Number/isSafeInteger
/uk/docs/Web/JavaScript/Reference/Global_Objects/Число/parseFloat	/uk/docs/Web/JavaScript/Reference/Global_Objects/Number/parseFloat
/uk/docs/Web/JavaScript/Reference/Global_Objects/Число/parseInt	/uk/docs/Web/JavaScript/Reference/Global_Objects/Number/parseInt
/uk/docs/Web/JavaScript/Reference/Global_Objects/Число/prototype	/uk/docs/conflicting/Web/JavaScript/Reference/Global_Objects/Number
/uk/docs/Web/JavaScript/Reference/Global_Objects/Число/toExponential	/uk/docs/Web/JavaScript/Reference/Global_Objects/Number/toExponential
/uk/docs/Web/JavaScript/Reference/Global_Objects/Число/toFixed	/uk/docs/Web/JavaScript/Reference/Global_Objects/Number/toFixed
/uk/docs/Web/JavaScript/Reference/Global_Objects/Число/toLocaleString	/uk/docs/Web/JavaScript/Reference/Global_Objects/Number/toLocaleString
/uk/docs/Web/JavaScript/Reference/Global_Objects/Число/toPrecision	/uk/docs/Web/JavaScript/Reference/Global_Objects/Number/toPrecision
/uk/docs/Web/JavaScript/Reference/Global_Objects/Число/toSource	/uk/docs/Web/JavaScript/Reference/Global_Objects/Number/toSource
/uk/docs/Web/JavaScript/Reference/Global_Objects/Число/toString	/uk/docs/Web/JavaScript/Reference/Global_Objects/Number/toString
/uk/docs/Web/JavaScript/Reference/Global_Objects/Число/valueOf	/uk/docs/Web/JavaScript/Reference/Global_Objects/Number/valueOf
/uk/docs/Web/JavaScript/Reference/Operators/Arithmetic_Operators	/uk/docs/conflicting/Web/JavaScript/Reference/Operators
/uk/docs/Web/JavaScript/Reference/Operators/Bitwise_Operators	/uk/docs/conflicting/Web/JavaScript/Reference/Operators_7c8eb9475d97a4a734c5991857698560
/uk/docs/Web/JavaScript/Reference/Operators/Logical_Operators	/uk/docs/conflicting/Web/JavaScript/Reference/Operators_f71733c8e7001a29c3ec40d8522a4aca
/uk/docs/Web/JavaScript/Reference/Operators/Ініціалізація_об’єктів	/uk/docs/Web/JavaScript/Reference/Operators/Object_initializer
/uk/docs/Web/JavaScript/Reference/Operators/Деструктуризація	/uk/docs/Web/JavaScript/Reference/Operators/Destructuring_assignment
/uk/docs/Web/JavaScript/Reference/Operators/Оператор_поширення	/uk/docs/conflicting/Web/JavaScript/Reference/Operators/Spread_syntax
/uk/docs/Web/JavaScript/Reference/Operators/Оператор_розпакування	/uk/docs/conflicting/Web/JavaScript/Reference/Operators/Spread_syntax
/uk/docs/Web/JavaScript/Reference/Operators/Оператори_порівняння	/uk/docs/conflicting/Web/JavaScript/Reference/Operators_a8aa9ce42ce1749862961c61113d120b
/uk/docs/Web/JavaScript/Reference/Operators/Оператори_присвоєння	/uk/docs/conflicting/Web/JavaScript/Reference/Operators_1cd48548c16282df3883f99267726c3e
/uk/docs/Web/JavaScript/Reference/Statements/default	/uk/docs/conflicting/Web/JavaScript/Reference/Statements/switch
/uk/docs/Web/JavaScript/Reference/Протоколи_перебору	/uk/docs/Web/JavaScript/Reference/Iteration_protocols
/uk/docs/Web/JavaScript/Reference/Список_методів	/uk/docs/Web/JavaScript/Reference
/uk/docs/Web/JavaScript/oglyad_tehnologiy_JavaScript	/uk/docs/Web/JavaScript/JavaScript_technologies_overview
/uk/docs/Web/JavaScript/Перевірка_на_рівність_та_однаковість	/uk/docs/Web/JavaScript/Equality_comparisons_and_sameness
/uk/docs/Web/Гудіні	/uk/docs/Web/Houdini
/uk/docs/Web/Застосунки/Новітні	/uk/docs/Web/Progressive_web_apps
/uk/docs/Web/Посібники	/uk/docs/Web/Tutorials
/uk/docs/Інструменти	/uk/docs/Tools
/uk/docs/Інструменти/Network_Monitor	/uk/docs/Tools/Network_Monitor
/uk/docs/Інструменти/Network_Monitor/Performance_Analysis	/uk/docs/Tools/Network_Monitor/Performance_Analysis
/uk/docs/Інструменти/Network_Monitor/Throttling	/uk/docs/Tools/Network_Monitor/Throttling
/uk/docs/Інструменти/Network_Monitor/recording	/uk/docs/Tools/Network_Monitor/recording
/uk/docs/Інструменти/Network_Monitor/request_details	/uk/docs/Tools/Network_Monitor/request_details
/uk/docs/Інструменти/Network_Monitor/request_list	/uk/docs/Tools/Network_Monitor/request_list
/uk/docs/Інструменти/Network_Monitor/toolbar	/uk/docs/Tools/Network_Monitor/toolbar
/uk/docs/Інструменти/Web_Console	/uk/docs/Tools/Web_Console
/uk/docs/Інструменти/Web_Console/Console_messages	/uk/docs/Tools/Web_Console/Console_messages
/uk/docs/Інструменти/Web_Console/Opening_the_Web_Console	/uk/docs/Tools/Web_Console/UI_Tour
/uk/docs/Інструменти/Web_Console/Split_console	/uk/docs/Tools/Web_Console/Split_console
/uk/docs/Оператор_розпакування	/uk/docs/conflicting/Web/JavaScript/Reference/Operators/Spread_syntax
