# FROM-URL	TO-URL
/de/docs/AJAX	/de/docs/Web/Guide/AJAX
/de/docs/Apps/Progressiv	/de/docs/Web/Progressive_web_apps
/de/docs/Barrierefreiheit	/de/docs/Web/Accessibility
/de/docs/Barrierefreiheit/ARIA	/de/docs/Web/Accessibility/ARIA
/de/docs/Barrierefreiheit/ARIA/ARIA_Live_Regionen	/de/docs/Web/Accessibility/ARIA/ARIA_Live_Regions
/de/docs/Barrierefreiheit/An_overview_of_accessible_web_applications_and_widgets	/de/docs/Web/Accessibility/An_overview_of_accessible_web_applications_and_widgets
/de/docs/Barrierefreiheit/Webentwicklung	/de/docs/conflicting/Web/Accessibility
/de/docs/Benutzen_des_Zwischenspeichers_in_Firefox_1.5_(caching)	/de/docs/Mozilla/Firefox/Releases/1.5/Using_Firefox_1.5_caching
/de/docs/Bug-Entdecken_Leitfaden	/de/docs/Richtlinien_zum_Schreiben_eines_Bugreports
/de/docs/Building_an_Extension	/de/docs/conflicting/Mozilla/Add-ons
/de/docs/CSS	/de/docs/Web/CSS
/de/docs/CSS/-moz-border-radius	/de/docs/Web/CSS/border-radius
/de/docs/CSS/-moz-border-radius-bottomleft	/de/docs/Web/CSS/border-bottom-left-radius
/de/docs/CSS/-moz-border-radius-bottomright	/de/docs/Web/CSS/border-bottom-right-radius
/de/docs/CSS/-moz-border-radius-topleft	/de/docs/Web/CSS/border-top-left-radius
/de/docs/CSS/-moz-border-radius-topright	/de/docs/Web/CSS/border-top-right-radius
/de/docs/CSS/-moz-box-shadow	/de/docs/Web/CSS/box-shadow
/de/docs/CSS/-moz-image-region	/de/docs/Web/CSS/-moz-image-region
/de/docs/CSS/-moz-user-input	/de/docs/Web/CSS/-moz-user-input
/de/docs/CSS/-moz-user-modify	/de/docs/Web/CSS/user-modify
/de/docs/CSS/-moz-user-select	/de/docs/Web/CSS/user-select
/de/docs/CSS/:empty	/de/docs/Web/CSS/:empty
/de/docs/CSS/:lang	/de/docs/Web/CSS/:lang
/de/docs/CSS/@import	/de/docs/Web/CSS/@import
/de/docs/CSS/Attributselektoren	/de/docs/Web/CSS/Attribute_selectors
/de/docs/CSS/Border-bottom-width	/de/docs/Web/CSS/Border-bottom-width
/de/docs/CSS/Border-left-width	/de/docs/Web/CSS/Border-left-width
/de/docs/CSS/Border-right-width	/de/docs/Web/CSS/Border-right-width
/de/docs/CSS/Border-top-width	/de/docs/Web/CSS/Border-top-width
/de/docs/CSS/Bottom	/de/docs/Web/CSS/Bottom
/de/docs/CSS/Boxmodell	/de/docs/Web/CSS/CSS_Box_Model/Introduction_to_the_CSS_box_model
/de/docs/CSS/CSS_Reference/Property_Template	/de/docs/orphaned/MDN/Contribute/Howto/Document_a_CSS_property/Property_template
/de/docs/CSS/CSS_Werte_Geltung	/de/docs/Web/CSS
/de/docs/CSS/CSS_animated_properties	/de/docs/Web/CSS
/de/docs/CSS/CSS_animierbare_Eigenschaften	/de/docs/Web/CSS
/de/docs/CSS/CSS_prozentuale_werte	/de/docs/Web/CSS
/de/docs/CSS/CSS_werte_syntax	/de/docs/Web/CSS
/de/docs/CSS/Einf√ºhrung	/de/docs/conflicting/Learn/CSS/First_steps
/de/docs/CSS/Farben	/de/docs/Web/CSS/color_value
/de/docs/CSS/Getting_Started	/de/docs/conflicting/Learn/CSS/First_steps
/de/docs/CSS/Getting_Started-weiterleitung-1	/de/docs/conflicting/Learn/CSS/First_steps
/de/docs/CSS/Initialwert	/de/docs/Web/CSS/initial_value
/de/docs/CSS/Left	/de/docs/Web/CSS/Left
/de/docs/CSS/Right	/de/docs/Web/CSS/Right
/de/docs/CSS/Top	/de/docs/Web/CSS/Top
/de/docs/CSS/Vererbung	/de/docs/Web/CSS/inheritance
/de/docs/CSS/Vorlage	/de/docs/orphaned/MDN/Contribute/Howto/Document_a_CSS_property/Property_template
/de/docs/CSS/Wertdefinitionssyntax	/de/docs/Web/CSS/Value_definition_syntax
/de/docs/CSS/background	/de/docs/Web/CSS/background
/de/docs/CSS/background-attachment	/de/docs/Web/CSS/background-attachment
/de/docs/CSS/background-clip	/de/docs/Web/CSS/background-clip
/de/docs/CSS/background-color	/de/docs/Web/CSS/background-color
/de/docs/CSS/background-image	/de/docs/Web/CSS/background-image
/de/docs/CSS/background-origin	/de/docs/Web/CSS/background-origin
/de/docs/CSS/background-position	/de/docs/Web/CSS/background-position
/de/docs/CSS/background-repeat	/de/docs/Web/CSS/background-repeat
/de/docs/CSS/background-size	/de/docs/Web/CSS/background-size
/de/docs/CSS/berechneter_Wert	/de/docs/Web/CSS/computed_value
/de/docs/CSS/border	/de/docs/Web/CSS/border
/de/docs/CSS/border-bottom	/de/docs/Web/CSS/border-bottom
/de/docs/CSS/border-bottom-color	/de/docs/Web/CSS/border-bottom-color
/de/docs/CSS/border-bottom-left-radius	/de/docs/Web/CSS/border-bottom-left-radius
/de/docs/CSS/border-bottom-right-radius	/de/docs/Web/CSS/border-bottom-right-radius
/de/docs/CSS/border-bottom-style	/de/docs/Web/CSS/border-bottom-style
/de/docs/CSS/border-collapse	/de/docs/Web/CSS/border-collapse
/de/docs/CSS/border-color	/de/docs/Web/CSS/border-color
/de/docs/CSS/border-left	/de/docs/Web/CSS/border-left
/de/docs/CSS/border-left-color	/de/docs/Web/CSS/border-left-color
/de/docs/CSS/border-left-style	/de/docs/Web/CSS/border-left-style
/de/docs/CSS/border-radius	/de/docs/Web/CSS/border-radius
/de/docs/CSS/border-right	/de/docs/Web/CSS/border-right
/de/docs/CSS/border-right-color	/de/docs/Web/CSS/border-right-color
/de/docs/CSS/border-right-style	/de/docs/Web/CSS/border-right-style
/de/docs/CSS/border-spacing	/de/docs/Web/CSS/border-spacing
/de/docs/CSS/border-style	/de/docs/Web/CSS/border-style
/de/docs/CSS/border-top	/de/docs/Web/CSS/border-top
/de/docs/CSS/border-top-color	/de/docs/Web/CSS/border-top-color
/de/docs/CSS/border-top-left-radius	/de/docs/Web/CSS/border-top-left-radius
/de/docs/CSS/border-top-right-radius	/de/docs/Web/CSS/border-top-right-radius
/de/docs/CSS/border-top-style	/de/docs/Web/CSS/border-top-style
/de/docs/CSS/border-width	/de/docs/Web/CSS/border-width
/de/docs/CSS/box-shadow	/de/docs/Web/CSS/box-shadow
/de/docs/CSS/box-sizing	/de/docs/Web/CSS/box-sizing
/de/docs/CSS/calc	/de/docs/Web/CSS/calc()
/de/docs/CSS/clear	/de/docs/Web/CSS/clear
/de/docs/CSS/color	/de/docs/Web/CSS/color
/de/docs/CSS/cursor	/de/docs/Web/CSS/cursor
/de/docs/CSS/display	/de/docs/Web/CSS/display
/de/docs/CSS/empty-cells	/de/docs/Web/CSS/empty-cells
/de/docs/CSS/float	/de/docs/Web/CSS/float
/de/docs/CSS/font	/de/docs/Web/CSS/font
/de/docs/CSS/height	/de/docs/Web/CSS/height
/de/docs/CSS/hyphens	/de/docs/Web/CSS/hyphens
/de/docs/CSS/list-style	/de/docs/Web/CSS/list-style
/de/docs/CSS/margin	/de/docs/Web/CSS/margin
/de/docs/CSS/margin-bottom	/de/docs/Web/CSS/margin-bottom
/de/docs/CSS/margin-left	/de/docs/Web/CSS/margin-left
/de/docs/CSS/margin-right	/de/docs/Web/CSS/margin-right
/de/docs/CSS/margin-top	/de/docs/Web/CSS/margin-top
/de/docs/CSS/max-height	/de/docs/Web/CSS/max-height
/de/docs/CSS/max-width	/de/docs/Web/CSS/max-width
/de/docs/CSS/min-height	/de/docs/Web/CSS/min-height
/de/docs/CSS/min-width	/de/docs/Web/CSS/min-width
/de/docs/CSS/opacity	/de/docs/Web/CSS/opacity
/de/docs/CSS/overflow	/de/docs/Web/CSS/overflow
/de/docs/CSS/padding	/de/docs/Web/CSS/padding
/de/docs/CSS/padding-bottom	/de/docs/Web/CSS/padding-bottom
/de/docs/CSS/padding-left	/de/docs/Web/CSS/padding-left
/de/docs/CSS/padding-right	/de/docs/Web/CSS/padding-right
/de/docs/CSS/padding-top	/de/docs/Web/CSS/padding-top
/de/docs/CSS/page-break-after	/de/docs/Web/CSS/page-break-after
/de/docs/CSS/page-break-before	/de/docs/Web/CSS/page-break-before
/de/docs/CSS/page-break-inside	/de/docs/Web/CSS/page-break-inside
/de/docs/CSS/position	/de/docs/Web/CSS/position
/de/docs/CSS/resize	/de/docs/Web/CSS/resize
/de/docs/CSS/text-align	/de/docs/Web/CSS/text-align
/de/docs/CSS/text-decoration	/de/docs/Web/CSS/text-decoration
/de/docs/CSS/text-decoration-color	/de/docs/Web/CSS/text-decoration-color
/de/docs/CSS/text-shadow	/de/docs/Web/CSS/text-shadow
/de/docs/CSS/time	/de/docs/Web/CSS/time
/de/docs/CSS/vertical-align	/de/docs/Web/CSS/vertical-align
/de/docs/CSS/visibility	/de/docs/Web/CSS/visibility
/de/docs/CSS/width	/de/docs/Web/CSS/width
/de/docs/CSS3_Columns	/de/docs/Web/CSS/CSS_Columns/Using_multi-column_layouts
/de/docs/CSS:-moz-border-radius	/de/docs/Web/CSS/border-radius
/de/docs/CSS:-moz-border-radius-bottomleft	/de/docs/Web/CSS/border-bottom-left-radius
/de/docs/CSS:-moz-border-radius-bottomright	/de/docs/Web/CSS/border-bottom-right-radius
/de/docs/CSS:-moz-border-radius-topleft	/de/docs/Web/CSS/border-top-left-radius
/de/docs/CSS:-moz-border-radius-topright	/de/docs/Web/CSS/border-top-right-radius
/de/docs/CSS:-moz-user-input	/de/docs/Web/CSS/-moz-user-input
/de/docs/CSS:-moz-user-modify	/de/docs/Web/CSS/user-modify
/de/docs/CSS:-moz-user-select	/de/docs/Web/CSS/user-select
/de/docs/CSS::empty	/de/docs/Web/CSS/:empty
/de/docs/CSS::lang	/de/docs/Web/CSS/:lang
/de/docs/CSS:@import	/de/docs/Web/CSS/@import
/de/docs/CSS:Boxmodell	/de/docs/Web/CSS/CSS_Box_Model/Introduction_to_the_CSS_box_model
/de/docs/CSS:Farben	/de/docs/Web/CSS/color_value
/de/docs/CSS:Vorlage	/de/docs/orphaned/MDN/Contribute/Howto/Document_a_CSS_property/Property_template
/de/docs/CSS:background	/de/docs/Web/CSS/background
/de/docs/CSS:background-attachment	/de/docs/Web/CSS/background-attachment
/de/docs/CSS:background-color	/de/docs/Web/CSS/background-color
/de/docs/CSS:background-image	/de/docs/Web/CSS/background-image
/de/docs/CSS:background-position	/de/docs/Web/CSS/background-position
/de/docs/CSS:background-repeat	/de/docs/Web/CSS/background-repeat
/de/docs/CSS:border	/de/docs/Web/CSS/border
/de/docs/CSS:border-bottom	/de/docs/Web/CSS/border-bottom
/de/docs/CSS:border-bottom-color	/de/docs/Web/CSS/border-bottom-color
/de/docs/CSS:border-bottom-style	/de/docs/Web/CSS/border-bottom-style
/de/docs/CSS:border-collapse	/de/docs/Web/CSS/border-collapse
/de/docs/CSS:border-color	/de/docs/Web/CSS/border-color
/de/docs/CSS:border-left	/de/docs/Web/CSS/border-left
/de/docs/CSS:border-left-color	/de/docs/Web/CSS/border-left-color
/de/docs/CSS:border-left-style	/de/docs/Web/CSS/border-left-style
/de/docs/CSS:border-right	/de/docs/Web/CSS/border-right
/de/docs/CSS:border-right-color	/de/docs/Web/CSS/border-right-color
/de/docs/CSS:border-right-style	/de/docs/Web/CSS/border-right-style
/de/docs/CSS:border-spacing	/de/docs/Web/CSS/border-spacing
/de/docs/CSS:border-style	/de/docs/Web/CSS/border-style
/de/docs/CSS:border-top	/de/docs/Web/CSS/border-top
/de/docs/CSS:border-top-color	/de/docs/Web/CSS/border-top-color
/de/docs/CSS:border-top-style	/de/docs/Web/CSS/border-top-style
/de/docs/CSS:border-width	/de/docs/Web/CSS/border-width
/de/docs/CSS:clear	/de/docs/Web/CSS/clear
/de/docs/CSS:color	/de/docs/Web/CSS/color
/de/docs/CSS:cursor	/de/docs/Web/CSS/cursor
/de/docs/CSS:display	/de/docs/Web/CSS/display
/de/docs/CSS:empty-cells	/de/docs/Web/CSS/empty-cells
/de/docs/CSS:float	/de/docs/Web/CSS/float
/de/docs/CSS:font	/de/docs/Web/CSS/font
/de/docs/CSS:height	/de/docs/Web/CSS/height
/de/docs/CSS:list-style	/de/docs/Web/CSS/list-style
/de/docs/CSS:margin	/de/docs/Web/CSS/margin
/de/docs/CSS:margin-bottom	/de/docs/Web/CSS/margin-bottom
/de/docs/CSS:margin-left	/de/docs/Web/CSS/margin-left
/de/docs/CSS:margin-right	/de/docs/Web/CSS/margin-right
/de/docs/CSS:margin-top	/de/docs/Web/CSS/margin-top
/de/docs/CSS:max-height	/de/docs/Web/CSS/max-height
/de/docs/CSS:max-width	/de/docs/Web/CSS/max-width
/de/docs/CSS:min-height	/de/docs/Web/CSS/min-height
/de/docs/CSS:min-width	/de/docs/Web/CSS/min-width
/de/docs/CSS:opacity	/de/docs/Web/CSS/opacity
/de/docs/CSS:overflow	/de/docs/Web/CSS/overflow
/de/docs/CSS:padding	/de/docs/Web/CSS/padding
/de/docs/CSS:padding-bottom	/de/docs/Web/CSS/padding-bottom
/de/docs/CSS:padding-left	/de/docs/Web/CSS/padding-left
/de/docs/CSS:padding-right	/de/docs/Web/CSS/padding-right
/de/docs/CSS:padding-top	/de/docs/Web/CSS/padding-top
/de/docs/CSS:page-break-after	/de/docs/Web/CSS/page-break-after
/de/docs/CSS:page-break-before	/de/docs/Web/CSS/page-break-before
/de/docs/CSS:page-break-inside	/de/docs/Web/CSS/page-break-inside
/de/docs/CSS:position	/de/docs/Web/CSS/position
/de/docs/CSS:text-align	/de/docs/Web/CSS/text-align
/de/docs/CSS:text-decoration	/de/docs/Web/CSS/text-decoration
/de/docs/CSS:vertical-align	/de/docs/Web/CSS/vertical-align
/de/docs/CSS:visibility	/de/docs/Web/CSS/visibility
/de/docs/CSS:width	/de/docs/Web/CSS/width
/de/docs/CSS_Referenz	/de/docs/Web/CSS/Reference
/de/docs/CSS_Referenz/Mozilla_CSS_Erweiterungen	/de/docs/Web/CSS/Mozilla_Extensions
/de/docs/CSS_in_HTML_einbinden	/de/docs/Web/CSS/@import
/de/docs/Code_snippets	/de/docs/Codeschnipsel
/de/docs/Code_snippets/Scrollbar	/de/docs/Codeschnipsel/Scrollbar
/de/docs/Code_snippets/Windows	/de/docs/Codeschnipsel/Windows
/de/docs/Creating_a_Skin_for_Firefox	/de/docs/Theme_erstellen
/de/docs/Creating_a_Skin_for_Firefox/contents.rdf	/de/docs/Theme_erstellen/contents.rdf
/de/docs/Creating_a_Skin_for_Firefox/install.rdf	/de/docs/Theme_erstellen/install.rdf
/de/docs/Creating_a_Skin_for_Firefox:contents.rdf	/de/docs/Theme_erstellen/contents.rdf
/de/docs/Creating_a_Skin_for_Firefox:install.rdf	/de/docs/Theme_erstellen/install.rdf
/de/docs/DOM	/de/docs/Web/API/Document_Object_Model
/de/docs/DOM/File.fileName	/de/docs/Web/API/File/fileName
/de/docs/DOM/File.fileSize	/de/docs/Web/API/File/fileSize
/de/docs/DOM/File.getAsText	/de/docs/Web/API/File/getAsText
/de/docs/DOM/File.name	/de/docs/Web/API/File/name
/de/docs/DOM/Node	/de/docs/Web/API/Node
/de/docs/DOM/Node.childNodes	/de/docs/Web/API/Node/childNodes
/de/docs/DOM/Node.firstChild	/de/docs/Web/API/Node/firstChild
/de/docs/DOM/Node.lastChild	/de/docs/Web/API/Node/lastChild
/de/docs/DOM/Node.nextSibling	/de/docs/Web/API/Node/nextSibling
/de/docs/DOM/Node.parentNode	/de/docs/Web/API/Node/parentNode
/de/docs/DOM/Node.previousSibling	/de/docs/Web/API/Node/previousSibling
/de/docs/DOM/Node.replaceChild	/de/docs/Web/API/Node/replaceChild
/de/docs/DOM/Node.textContent	/de/docs/Web/API/Node/textContent
/de/docs/DOM/Ueber_das_Document_Object_Model	/de/docs/conflicting/Web/API/Document_Object_Model
/de/docs/DOM/XMLHttpRequest	/de/docs/Web/API/XMLHttpRequest
/de/docs/DOM/document	/de/docs/Web/API/Document
/de/docs/DOM/document.createElement	/de/docs/Web/API/Document/createElement
/de/docs/DOM/element	/de/docs/Web/API/Element
/de/docs/DOM/window	/de/docs/Web/API/Window
/de/docs/DOM/window.dump	/de/docs/Web/API/Window/dump
/de/docs/DOM/window.openDialog	/de/docs/Web/API/Window/openDialog
/de/docs/DOM/window.setTimeout	/de/docs/Web/API/WindowOrWorkerGlobalScope/setTimeout
/de/docs/DOM_Inspector	/de/docs/orphaned/Tools/Add-ons/DOM_Inspector
/de/docs/Developer_Guide	/de/docs/Mozilla/Developer_guide
/de/docs/Developer_Guide/firefox_erfolgreich_erstellt	/de/docs/Mozilla/Developer_guide/So_you_just_built_Firefox
/de/docs/DragDrop	/de/docs/Web/API/HTML_Drag_and_Drop_API
/de/docs/Eine_erste_Erweiterung_erstellen	/de/docs/conflicting/Mozilla/Add-ons
/de/docs/Einf√ºhrung_in_den_Gebrauch_von_XPath_in_JavaScript	/de/docs/Web/XPath/Introduction_to_using_XPath_in_JavaScript
/de/docs/Entwicklerhandbuch	/de/docs/Mozilla/Developer_guide
/de/docs/Entwicklerhandbuch/Quelltexte	/de/docs/Mozilla/Developer_guide/Source_Code
/de/docs/Erweiterung_erstellen	/de/docs/conflicting/Mozilla/Add-ons
/de/docs/Erweiterungen_f√ºr_Firefox_3_aktualisieren	/de/docs/Mozilla/Firefox/Releases/3/Updating_extensions
/de/docs/Farbverl√§ufe_in_CSS	/de/docs/Web/CSS/CSS_Images/Using_CSS_gradients
/de/docs/Firefox_1.5_Beta	/de/docs/Mozilla/Firefox/Releases/1.5
/de/docs/Firefox_1.5_f√ºr_Entwickler	/de/docs/Mozilla/Firefox/Releases/1.5
/de/docs/Firefox_1.5_f√ºr_Entwickler/Changing_the_priority_of_HTTP_requests	/de/docs/Mozilla/Firefox/Releases/1.5/Changing_the_priority_of_HTTP_requests
/de/docs/Firefox_3.5_f√ºr_Entwickler	/de/docs/Mozilla/Firefox/Releases/3.5
/de/docs/Firefox_3_f√ºr_Entwickler	/de/docs/Mozilla/Firefox/Releases/3
/de/docs/Glossary/Abstraktion	/de/docs/Glossary/Abstraction
/de/docs/Glossary/Algorithmus	/de/docs/Glossary/Algorithm
/de/docs/Glossary/Anweisung	/de/docs/Glossary/Statement
/de/docs/Glossary/Asynchron	/de/docs/Glossary/Asynchronous
/de/docs/Glossary/Bandbreite	/de/docs/Glossary/Bandwidth
/de/docs/Glossary/CORS-zugelassener-anfrage-header	/de/docs/Glossary/CORS-safelisted_request_header
/de/docs/Glossary/CSS_Praeprozessor	/de/docs/Glossary/CSS_preprocessor
/de/docs/Glossary/DTD	/de/docs/conflicting/Glossary/Doctype
/de/docs/Glossary/Datenkapselung	/de/docs/Glossary/Encapsulation
/de/docs/Glossary/Funktion_erster-Klasse	/de/docs/Glossary/First-class_Function
/de/docs/Glossary/Herstellerpr√§fix	/de/docs/Glossary/Vendor_Prefix
/de/docs/Glossary/Informationsarchitektur	/de/docs/Glossary/Information_architecture
/de/docs/Glossary/Klasse	/de/docs/Glossary/Class
/de/docs/Glossary/Konstruktor	/de/docs/Glossary/Constructor
/de/docs/Glossary/Leeres_Element	/de/docs/Glossary/Empty_element
/de/docs/Glossary/Objekt	/de/docs/Glossary/Object
/de/docs/Glossary/Protokoll	/de/docs/Glossary/Protocol
/de/docs/Glossary/Typ	/de/docs/Glossary/Type
/de/docs/Glossary/einfache_datenelemente	/de/docs/Glossary/Primitive
/de/docs/Glossary/verbotener_header_name	/de/docs/Glossary/Forbidden_header_name
/de/docs/HTML	/de/docs/Web/HTML
/de/docs/HTML/Block-level_elemente	/de/docs/Web/HTML/Block-level_elements
/de/docs/HTML/Element	/de/docs/Web/HTML/Element
/de/docs/HTML/Element/Input	/de/docs/Web/HTML/Element/Input
/de/docs/HTML/Element/b	/de/docs/Web/HTML/Element/b
/de/docs/HTML/Element/br	/de/docs/Web/HTML/Element/br
/de/docs/HTML/Element/canvas	/de/docs/Web/HTML/Element/canvas
/de/docs/HTML/Element/datalist	/de/docs/Web/HTML/Element/datalist
/de/docs/HTML/Element/h1	/de/docs/Web/HTML/Element/Heading_Elements
/de/docs/HTML/Element/h1-h6	/de/docs/Web/HTML/Element/Heading_Elements
/de/docs/HTML/Element/h2	/de/docs/Web/HTML/Element/Heading_Elements
/de/docs/HTML/Element/h3	/de/docs/Web/HTML/Element/Heading_Elements
/de/docs/HTML/Element/h4	/de/docs/Web/HTML/Element/Heading_Elements
/de/docs/HTML/Element/h5	/de/docs/Web/HTML/Element/Heading_Elements
/de/docs/HTML/Element/h6	/de/docs/Web/HTML/Element/Heading_Elements
/de/docs/HTML/Element/head	/de/docs/Web/API/HTMLHeadElement
/de/docs/HTML/Element/hr	/de/docs/Web/HTML/Element/hr
/de/docs/HTML/Element/html	/de/docs/Web/HTML/Element/html
/de/docs/HTML/Element/iframe	/de/docs/Web/HTML/Element/iframe
/de/docs/HTML/Element/li	/de/docs/Web/HTML/Element/li
/de/docs/HTML/Element/noscript	/de/docs/Web/HTML/Element/noscript
/de/docs/HTML/Element/ol	/de/docs/Web/HTML/Element/ol
/de/docs/HTML/Element/p	/de/docs/Web/HTML/Element/p
/de/docs/HTML/Element/pre	/de/docs/Web/HTML/Element/pre
/de/docs/HTML/Element/strong	/de/docs/Web/HTML/Element/strong
/de/docs/HTML/Element/time	/de/docs/Web/HTML/Element/time
/de/docs/HTML/Element/ul	/de/docs/Web/HTML/Element/ul
/de/docs/HTML/Element/var	/de/docs/Web/HTML/Element/var
/de/docs/HTML/HTML5	/de/docs/Web/Guide/HTML/HTML5
/de/docs/HTML/HTML5/HTML5_element_list	/de/docs/conflicting/Web/HTML/Element
/de/docs/HTML/HTML5/liste_der_HTML5_elemente	/de/docs/conflicting/Web/HTML/Element
/de/docs/HTML/Inline_elemente	/de/docs/Web/HTML/Inline_elements
/de/docs/HTML/Using_the_application_cache	/de/docs/Web/HTML/Using_the_application_cache
/de/docs/HTML:Element	/de/docs/Web/HTML/Element
/de/docs/HTML:Element:b	/de/docs/Web/HTML/Element/b
/de/docs/HTML:Element:h1	/de/docs/Web/HTML/Element/Heading_Elements
/de/docs/HTML:Element:h2	/de/docs/Web/HTML/Element/Heading_Elements
/de/docs/HTML:Element:h3	/de/docs/Web/HTML/Element/Heading_Elements
/de/docs/HTML:Element:h4	/de/docs/Web/HTML/Element/Heading_Elements
/de/docs/HTML:Element:h5	/de/docs/Web/HTML/Element/Heading_Elements
/de/docs/HTML:Element:h6	/de/docs/Web/HTML/Element/Heading_Elements
/de/docs/HTML:Element:head	/de/docs/Web/API/HTMLHeadElement
/de/docs/HTML:Element:hr	/de/docs/Web/HTML/Element/hr
/de/docs/HTML:Element:html	/de/docs/Web/HTML/Element/html
/de/docs/HTML:Element:iframe	/de/docs/Web/HTML/Element/iframe
/de/docs/HTML:Element:li	/de/docs/Web/HTML/Element/li
/de/docs/HTML:Element:ol	/de/docs/Web/HTML/Element/ol
/de/docs/HTML:Element:p	/de/docs/Web/HTML/Element/p
/de/docs/HTML:Element:strong	/de/docs/Web/HTML/Element/strong
/de/docs/HTML:Element:ul	/de/docs/Web/HTML/Element/ul
/de/docs/HTML:Element:var	/de/docs/Web/HTML/Element/var
/de/docs/HTTP_Request_Header_setzen	/de/docs/XPCOM/HTTP_Request_Header_setzen
/de/docs/Hauptseite	/de/docs/Web
/de/docs/IndexedDB	/de/docs/Web/API/IndexedDB_API
/de/docs/IndexedDB/Browser_storage_limits_and_eviction_criteria	/de/docs/Web/API/IndexedDB_API/Browser_storage_limits_and_eviction_criteria
/de/docs/IndexedDB/Grundkonzepte_hinter_IndexedDB	/de/docs/Web/API/IndexedDB_API/Basic_Concepts_Behind_IndexedDB
/de/docs/IndexedDB/IndexedDB_verwenden	/de/docs/Web/API/IndexedDB_API/Using_IndexedDB
/de/docs/JavaScript	/de/docs/Web/JavaScript
/de/docs/JavaScript/Eine_Wiedereinfuehrung_in_JavaScript	/de/docs/Web/JavaScript/A_re-introduction_to_JavaScript
/de/docs/JavaScript/Guide	/de/docs/Web/JavaScript/Guide
/de/docs/JavaScript/Guide/Ausdruecke_und_Operatoren	/de/docs/Web/JavaScript/Guide/Expressions_and_Operators
/de/docs/JavaScript/Guide/Closures	/de/docs/Web/JavaScript/Closures
/de/docs/JavaScript/Guide/Feinheiten_des_Objektmodells	/de/docs/Web/JavaScript/Guide/Details_of_the_Object_Model
/de/docs/JavaScript/Guide/Funktionen	/de/docs/Web/JavaScript/Guide/Functions
/de/docs/JavaScript/Guide/Mit_Objekten_arbeiten	/de/docs/Web/JavaScript/Guide/Working_with_Objects
/de/docs/JavaScript/Guide/Regular_Expressions	/de/docs/Web/JavaScript/Guide/Regular_Expressions
/de/docs/JavaScript/Guide/Statements	/de/docs/Web/JavaScript/Guide/Control_flow_and_error_handling
/de/docs/JavaScript/Guide/Ueber_JavaScript	/de/docs/Web/JavaScript/Guide/Introduction
/de/docs/JavaScript/Guide/Ueber_diese_Einfuehrung	/de/docs/Web/JavaScript/Guide/Introduction
/de/docs/JavaScript/Guide/Vererbung_ueberdacht	/de/docs/Web/JavaScript/Inheritance_and_the_prototype_chain
/de/docs/JavaScript/Guide/Vordefinierte_Kernobjekte	/de/docs/Web/JavaScript/Guide
/de/docs/JavaScript/Guide/Werte_Variablen_und_Literale	/de/docs/Web/JavaScript/Guide/Grammar_and_types
/de/docs/JavaScript/Guide/√úber_Javascript	/de/docs/Web/JavaScript/Guide/Introduction
/de/docs/JavaScript/Guide/√úber_diese_Einf√ºhrung	/de/docs/Web/JavaScript/Guide/Introduction
/de/docs/JavaScript/Javascript_lernen_f√ºr_Anf√§nger	/de/docs/Web/JavaScript/Guide
/de/docs/JavaScript/Language_Resources	/de/docs/Web/JavaScript/Language_Resources
/de/docs/JavaScript/Reference	/de/docs/Web/JavaScript/Reference
/de/docs/JavaScript/Reference/Global_Objects	/de/docs/Web/JavaScript/Reference/Global_Objects
/de/docs/JavaScript/Reference/Global_Objects/Array	/de/docs/Web/JavaScript/Reference/Global_Objects/Array
/de/docs/JavaScript/Reference/Global_Objects/Array/isArray	/de/docs/Web/JavaScript/Reference/Global_Objects/Array/isArray
/de/docs/JavaScript/Reference/Global_Objects/Array/pop	/de/docs/Web/JavaScript/Reference/Global_Objects/Array/pop
/de/docs/JavaScript/Reference/Global_Objects/Array/push	/de/docs/Web/JavaScript/Reference/Global_Objects/Array/push
/de/docs/JavaScript/Reference/Global_Objects/Array/reverse	/de/docs/Web/JavaScript/Reference/Global_Objects/Array/reverse
/de/docs/JavaScript/Reference/Global_Objects/Array/shift	/de/docs/Web/JavaScript/Reference/Global_Objects/Array/shift
/de/docs/JavaScript/Reference/Global_Objects/Date	/de/docs/Web/JavaScript/Reference/Global_Objects/Date
/de/docs/JavaScript/Reference/Global_Objects/Date/now	/de/docs/Web/JavaScript/Reference/Global_Objects/Date/now
/de/docs/JavaScript/Reference/Global_Objects/NaN	/de/docs/Web/JavaScript/Reference/Global_Objects/NaN
/de/docs/JavaScript/Reference/Global_Objects/Number	/de/docs/Web/JavaScript/Reference/Global_Objects/Number
/de/docs/JavaScript/Reference/Global_Objects/Number/EPSILON	/de/docs/Web/JavaScript/Reference/Global_Objects/Number/EPSILON
/de/docs/JavaScript/Reference/Global_Objects/Object	/de/docs/Web/JavaScript/Reference/Global_Objects/Object
/de/docs/JavaScript/Reference/Global_Objects/Object/constructor	/de/docs/Web/JavaScript/Reference/Global_Objects/Object/constructor
/de/docs/JavaScript/Reference/Global_Objects/Object/is	/de/docs/Web/JavaScript/Reference/Global_Objects/Object/is
/de/docs/JavaScript/Reference/Global_Objects/RegExp	/de/docs/Web/JavaScript/Reference/Global_Objects/RegExp
/de/docs/JavaScript/Reference/Global_Objects/String	/de/docs/Web/JavaScript/Reference/Global_Objects/String
/de/docs/JavaScript/Reference/Global_Objects/String/replace	/de/docs/Web/JavaScript/Reference/Global_Objects/String/replace
/de/docs/JavaScript/Speicherverwaltung	/de/docs/Web/JavaScript/Memory_Management
/de/docs/JavaScript/java_guide	/de/docs/Web/JavaScript/Guide
/de/docs/JavaScript/javascript_guide	/de/docs/Web/JavaScript/Guide
/de/docs/JavaScript/javascript_guide/Anweisungen	/de/docs/Web/JavaScript/Guide/Control_flow_and_error_handling
/de/docs/JavaScript/javascript_guide/Ausdr√ºcke_und_Operatoren	/de/docs/Web/JavaScript/Guide/Expressions_and_Operators
/de/docs/JavaScript/javascript_guide/Funktionen	/de/docs/Web/JavaScript/Guide/Functions
/de/docs/JavaScript/javascript_guide/Javascript_√úbersicht	/de/docs/Web/JavaScript/Guide/Introduction
/de/docs/JavaScript/javascript_guide/Mit_Objekten_arbeiten	/de/docs/Web/JavaScript/Guide/Working_with_Objects
/de/docs/JavaScript/javascript_guide/Regul√§re_Ausdr√ºcke	/de/docs/Web/JavaScript/Guide/Regular_Expressions
/de/docs/JavaScript/javascript_guide/Werte,_Variable_und_Literale	/de/docs/Web/JavaScript/Guide/Grammar_and_types
/de/docs/JavaScript/javascript_guide/Werte,_Variablen_und_Literale	/de/docs/Web/JavaScript/Guide/Grammar_and_types
/de/docs/JavaScript/javascript_guide/ueber_javascript	/de/docs/Web/JavaScript/Guide/Introduction
/de/docs/JavaScript/javascript_guide/ueber_javascript/√úber_Javascript	/de/docs/Web/JavaScript/Guide/Introduction
/de/docs/JavaScript/javascript_guide/√úber_Javascript	/de/docs/Web/JavaScript/Guide/Introduction
/de/docs/JavaScript/javascript_guide/√úber_diese_Einf√ºhrung	/de/docs/Web/JavaScript/Guide/Introduction
/de/docs/JavaScript/ueber_JavaScript	/de/docs/Web/JavaScript/Guide/Introduction
/de/docs/JavaScript/ueber_JavaScript/√úber_Javascript	/de/docs/Web/JavaScript/Guide/Introduction
/de/docs/JavaScript/√úber_Javascript	/de/docs/Web/JavaScript/Guide/Introduction
/de/docs/Learn/CSS/Building_blocks/Werten_Einheiten	/de/docs/Learn/CSS/Building_blocks/Values_and_units
/de/docs/Learn/CSS/Introduction_to_CSS	/en-US/docs/Learn/CSS/First_steps
/de/docs/Learn/CSS/Introduction_to_CSS/Attribute_selectors	/en-US/docs/Learn/CSS/Building_blocks/Selectors/Attribute_selectors
/de/docs/Learn/CSS/Introduction_to_CSS/Cascade_and_inheritance	/en-US/docs/Learn/CSS/Building_blocks/Cascade_and_inheritance
/de/docs/Learn/CSS/Introduction_to_CSS/Combinators_and_multiple_selectors	/en-US/docs/Learn/CSS/Building_blocks/Selectors/Combinators
/de/docs/Learn/CSS/Introduction_to_CSS/How_CSS_works	/en-US/docs/Learn/CSS/First_steps/How_CSS_works
/de/docs/Learn/CSS/Introduction_to_CSS/Pseudo-classes_and_pseudo-elements	/en-US/docs/Learn/CSS/Building_blocks/Selectors/Pseudo-classes_and_pseudo-elements
/de/docs/Learn/CSS/Introduction_to_CSS/Simple_selectors	/en-US/docs/Learn/CSS/Building_blocks/Selectors/Type_Class_and_ID_Selectors
/de/docs/Learn/CSS/Introduction_to_CSS/Syntax	/en-US/docs/Learn/CSS/First_steps/How_CSS_is_structured
/de/docs/Learn/CSS/Introduction_to_CSS/Values_and_units	/en-US/docs/Learn/CSS/Building_blocks/Values_and_units
/de/docs/Learn/CSS/Styling_boxes	/en-US/docs/Learn/CSS/Building_blocks
/de/docs/Learn/Common_questions/Wie_das_Internet_funktioniert	/de/docs/Learn/Common_questions/How_does_the_Internet_work
/de/docs/Learn/Getting_started_with_the_web/JavaScript_basis	/de/docs/Learn/Getting_started_with_the_web/JavaScript_basics
/de/docs/Learn/Getting_started_with_the_web/Wie_das_Internet_funktioniert	/de/docs/Learn/Getting_started_with_the_web/How_the_Web_works
/de/docs/Learn/Getting_started_with_the_web/dateien_nutzen	/de/docs/Learn/Getting_started_with_the_web/Dealing_with_files
/de/docs/Learn/HTML/Einf√ºhrung_in_HTML	/de/docs/Learn/HTML/Introduction_to_HTML
/de/docs/Learn/HTML/Einf√ºhrung_in_HTML/Der_Kopf_Metadaten_in_HTML	/de/docs/Learn/HTML/Introduction_to_HTML/The_head_metadata_in_HTML
/de/docs/Learn/HTML/Einf√ºhrung_in_HTML/Document_and_website_structure	/de/docs/Learn/HTML/Introduction_to_HTML/Document_and_website_structure
/de/docs/Learn/HTML/Einf√ºhrung_in_HTML/Einfache_Textformatierung_in_HTML	/de/docs/Learn/HTML/Introduction_to_HTML/HTML_text_fundamentals
/de/docs/Learn/HTML/Einf√ºhrung_in_HTML/Erstellen_von_Hyperlinks	/de/docs/Learn/HTML/Introduction_to_HTML/Creating_hyperlinks
/de/docs/Learn/HTML/Einf√ºhrung_in_HTML/Fehlersuche_in_HTML	/de/docs/Learn/HTML/Introduction_to_HTML/Debugging_HTML
/de/docs/Learn/HTML/Einf√ºhrung_in_HTML/Fortgeschrittene_Textformatierung	/de/docs/Learn/HTML/Introduction_to_HTML/Advanced_text_formatting
/de/docs/Learn/HTML/Einf√ºhrung_in_HTML/Lerne_HTML_kennen	/de/docs/Learn/HTML/Introduction_to_HTML/Getting_started
/de/docs/Learn/HTML/Einf√ºhrung_in_HTML/Marking_up_a_letter	/de/docs/Learn/HTML/Introduction_to_HTML/Marking_up_a_letter
/de/docs/Learn/HTML/Einf√ºhrung_in_HTML/Structuring_a_page_of_content	/de/docs/Learn/HTML/Introduction_to_HTML/Structuring_a_page_of_content
/de/docs/Learn/HTML/Forms	/de/docs/Learn/Forms
/de/docs/Learn/HTML/Tables/Grund_tabelle_HTML	/de/docs/Learn/HTML/Tables/Basics
/de/docs/Learn/JavaScript/Bausteine	/de/docs/Learn/JavaScript/Building_blocks
/de/docs/Learn/JavaScript/Bausteine/Ereignisse	/de/docs/Learn/JavaScript/Building_blocks/Events
/de/docs/Learn/JavaScript/First_steps/Erster_Blick	/de/docs/Learn/JavaScript/First_steps/A_first_splash
/de/docs/Learn/JavaScript/First_steps/Was_ist_JavaScript	/de/docs/Learn/JavaScript/First_steps/What_is_JavaScript
/de/docs/Learn/JavaScript/First_steps/lustige_geschichten_generator	/de/docs/Learn/JavaScript/First_steps/Silly_story_generator
/de/docs/Learn/Mitarbeiten	/de/docs/orphaned/Learn/How_to_contribute
/de/docs/Learn/Server-side/Erste_Schritte	/de/docs/Learn/Server-side/First_steps
/de/docs/Learn/Server-side/Erste_Schritte/Introduction	/de/docs/Learn/Server-side/First_steps/Introduction
/de/docs/Lokalisierung	/de/docs/Glossary/Localization
/de/docs/MDN/Community	/de/docs/orphaned/MDN/Community
/de/docs/MDN/Community/Bleibe_auf_dem_Laufenden	/de/docs/orphaned/MDN/Community/Whats_happening
/de/docs/MDN/Contribute/Content	/de/docs/MDN/Guidelines
/de/docs/MDN/Contribute/Content/Style_guide	/de/docs/MDN/Guidelines/Writing_style_guide
/de/docs/MDN/Contribute/Guidelines	/de/docs/MDN/Guidelines
/de/docs/MDN/Contribute/Guidelines/Style_guide	/de/docs/MDN/Guidelines/Writing_style_guide
/de/docs/MDN/Contribute/Howto/Do_a_technical_review	/de/docs/orphaned/MDN/Contribute/Howto/Do_a_technical_review
/de/docs/MDN/Contribute/Howto/Do_an_editorial_review	/de/docs/orphaned/MDN/Contribute/Howto/Do_an_editorial_review
/de/docs/MDN/Contribute/Howto/ERstellung_eines_MDN_Profils	/de/docs/orphaned/MDN/Contribute/Howto/Create_an_MDN_account
/de/docs/MDN/Contribute/Howto/Schlagw√∂rter_f√ºr_JavaScript_Seiten	/de/docs/orphaned/MDN/Contribute/Howto/Tag_JavaScript_pages
/de/docs/MDN/Contribute/Howto/Set_the_summary_for_a_page	/de/docs/orphaned/MDN/Contribute/Howto/Set_the_summary_for_a_page
/de/docs/MDN/Contribute/Structures	/de/docs/MDN/Structures
/de/docs/MDN/Contribute/Structures/Kompatibilitaets_Tabellen	/de/docs/MDN/Structures/Compatibility_tables
/de/docs/MDN/Contribute/zu_tun_im_MDN	/de/docs/conflicting/MDN/Contribute/Getting_started
/de/docs/MDN/Erste_Schritte	/de/docs/MDN/Contribute/Getting_started
/de/docs/MDN/Feedback	/de/docs/MDN/Contribute/Feedback
/de/docs/MDN/Guidelines/Style_guide	/de/docs/MDN/Guidelines/Writing_style_guide
/de/docs/MDN/Kuma	/de/docs/MDN/Yari
/de/docs/MDN/Kuma/Beheben_von_KumaScript_Fehlern	/de/docs/MDN/Tools/KumaScript/Troubleshooting
/de/docs/MDN/Structures/Kompatibilitaets_Tabellen	/de/docs/MDN/Structures/Compatibility_tables
/de/docs/MDN/nutzer_leitfaden	/de/docs/MDN/Tools
/de/docs/MDN/√úber	/de/docs/MDN/About
/de/docs/MDN/√úber/Link_zu_MDN	/de/docs/orphaned/MDN/About/Linking_to_MDN
/de/docs/MDN_at_ten	/de/docs/MDN/At_ten
/de/docs/MDN_at_ten/History_of_MDN	/de/docs/MDN/At_ten/History_of_MDN
/de/docs/MDN_at_ten/Zum_MDN_beitragen	/de/docs/conflicting/MDN/Contribute
/de/docs/Mozilla/Add-ons/WebExtensions/API/Lesezeich.	/de/docs/Mozilla/Add-ons/WebExtensions/API/bookmarks
/de/docs/Mozilla/Add-ons/WebExtensions/Arbeiten_mit_Taps_API	/de/docs/Mozilla/Add-ons/WebExtensions/Working_with_the_Tabs_API
/de/docs/Mozilla/Add-ons/WebExtensions/Beispiele	/de/docs/Mozilla/Add-ons/WebExtensions/Examples
/de/docs/Mozilla/Add-ons/WebExtensions/Deine_erste_WebErweiterung	/de/docs/Mozilla/Add-ons/WebExtensions/Your_first_WebExtension
/de/docs/Mozilla/Add-ons/WebExtensions/Deine_zweite_Erweiterung	/de/docs/Mozilla/Add-ons/WebExtensions/Your_second_WebExtension
/de/docs/Mozilla/Developer_guide/Quelltexte	/de/docs/Mozilla/Developer_guide/Source_Code
/de/docs/Mozilla/Developer_guide/firefox_erfolgreich_erstellt	/de/docs/Mozilla/Developer_guide/So_you_just_built_Firefox
/de/docs/Mozilla_entwickeln	/de/docs/Mozilla/Developer_guide
/de/docs/Online_and_offline_events	/de/docs/Web/API/NavigatorOnLine/Online_and_offline_events
/de/docs/OpenSearch_Plugin_f√ºr_Firefox_erstellen	/de/docs/Web/OpenSearch
/de/docs/Plugins/Flash-Aktivierung:_Browser-Vergleich	/de/docs/orphaned/Plugins/Flash_Activation:_Browser_Comparison
/de/docs/Profilmanager	/de/docs/Profile_Manager
/de/docs/QA/Stress_Testing	/de/docs/Qualit√§tssicherung/Stress_Testing
/de/docs/QA:Stress_Testing	/de/docs/Qualit√§tssicherung/Stress_Testing
/de/docs/SVG	/de/docs/Web/SVG
/de/docs/SVG/Element	/de/docs/Web/SVG/Element
/de/docs/SVG/Element/animate	/de/docs/Web/SVG/Element/animate
/de/docs/SVG/Element/foreignObject	/de/docs/Web/SVG/Element/foreignObject
/de/docs/SVG/Tutorial	/de/docs/Web/SVG/Tutorial
/de/docs/SVG/Tutorial/Einf√ºhrung	/de/docs/Web/SVG/Tutorial/Introduction
/de/docs/Suche_Plugins	/de/docs/Web/OpenSearch
/de/docs/Theme_erstellen:Einf√ºhrung	/de/docs/Theme_erstellen/Einf√ºhrung
/de/docs/Theme_erstellen:UUID	/de/docs/Theme_erstellen/UUID
/de/docs/Theme_erstellen:contents.rdf	/de/docs/Theme_erstellen/contents.rdf
/de/docs/Theme_erstellen:install.rdf	/de/docs/Theme_erstellen/install.rdf
/de/docs/Themen	/de/docs/Themes
/de/docs/Tools/3D_untersuchung	/de/docs/Tools/3D_View
/de/docs/Tools/Add-ons	/de/docs/orphaned/Tools/Add-ons
/de/docs/Tools/Barrierefreiheits_inspektor	/de/docs/Tools/Accessibility_inspector
/de/docs/Tools/Browser_Werkzeuge	/de/docs/Tools/Browser_Toolbox
/de/docs/Tools/Page_Inspector/How_to/Event_Listener_untersuchen	/de/docs/Tools/Page_Inspector/How_to/Examine_event_listeners
/de/docs/Tools/Page_Inspector/How_to/Raster_Layout_untersuchen	/de/docs/Tools/Page_Inspector/How_to/Examine_grid_layouts
/de/docs/Tools/Page_Inspector/How_to/Schriftarten_Bearbeitung	/de/docs/Tools/Page_Inspector/How_to/Edit_fonts
/de/docs/Tools/Seiten_Inspektor	/de/docs/Tools/Page_Inspector
/de/docs/Tools/Seiten_Inspektor/Style_panel	/de/docs/Tools/Page_Inspector
/de/docs/Tools/Seiten_Inspektor/Tastenkombinationen	/de/docs/Tools/Page_Inspector/Keyboard_shortcuts
/de/docs/Tools/Shader-Editor	/de/docs/Tools/Shader_Editor
/de/docs/Tools/WebIDE_clone	/de/docs/orphaned/Tools/WebIDE_clone
/de/docs/Tools/Web_Konsole	/de/docs/Tools/Web_Console
/de/docs/Tools/Web_Konsole/Hilfe	/de/docs/Tools/Web_Console/Helpers
/de/docs/Tools/bildschirmgroessen-testen	/de/docs/Tools/Responsive_Design_Mode
/de/docs/Tools/netzwerkanalyse	/de/docs/Tools/Network_Monitor
/de/docs/Updating_web_applications_for_Firefox_3	/de/docs/Mozilla/Firefox/Releases/3/Updating_web_applications
/de/docs/Verwenden_des_Cache_beim_Firefox_1.5	/de/docs/Mozilla/Firefox/Releases/1.5/Using_Firefox_1.5_caching
/de/docs/Web/API/AudioContext/decodeAudioData	/de/docs/Web/API/BaseAudioContext/decodeAudioData
/de/docs/Web/API/CSSRule.cssText	/de/docs/Web/API/CSSRule/cssText
/de/docs/Web/API/Element.querySelector	/de/docs/Web/API/Element/querySelector
/de/docs/Web/API/File/Typ	/de/docs/Web/API/File/type
/de/docs/Web/API/File/Zugriff_auf_Dateien_von_Webapplikationen	/de/docs/Web/API/File/Using_files_from_web_applications
/de/docs/Web/API/IndexedDB_API/Grundkonzepte_hinter_IndexedDB	/de/docs/Web/API/IndexedDB_API/Basic_Concepts_Behind_IndexedDB
/de/docs/Web/API/IndexedDB_API/IndexedDB_verwenden	/de/docs/Web/API/IndexedDB_API/Using_IndexedDB
/de/docs/Web/API/MozMobileConnection.selectNetworkAutomatically	/de/docs/Web/API/MozMobileConnection/selectNetworkAutomatically
/de/docs/Web/API/Navigator/registerProtocolHandler/Webbasierte_protokoll-handler	/de/docs/Web/API/Navigator/registerProtocolHandler/Web-based_protocol_handlers
/de/docs/Web/API/Node.cloneNode	/de/docs/Web/API/Node/cloneNode
/de/docs/Web/API/Node/innerText	/de/docs/Web/API/HTMLElement/innerText
/de/docs/Web/API/Vollbild_API	/de/docs/Web/API/Fullscreen_API
/de/docs/Web/API/WebGL_API/3D-Objekte_mit_WebGL_erstellen	/de/docs/Web/API/WebGL_API/Tutorial/Creating_3D_objects_using_WebGL
/de/docs/Web/API/WebGL_API/Animierte_Texturen_in_WebGL	/de/docs/Web/API/WebGL_API/Tutorial/Animating_textures_in_WebGL
/de/docs/Web/API/WebGL_API/Beleuchtung_in_WebGL	/de/docs/Web/API/WebGL_API/Tutorial/Lighting_in_WebGL
/de/docs/Web/API/WebGL_API/Einf√ºhrung_in_WebGL	/de/docs/Web/API/WebGL_API/Tutorial/Getting_started_with_WebGL
/de/docs/Web/API/WebGL_API/Farben_mittels_Shader_in_einen_WebGL-Kontext_hinzuf√ºgen	/de/docs/Web/API/WebGL_API/Tutorial/Using_shaders_to_apply_color_in_WebGL
/de/docs/Web/API/WebGL_API/Hinzuf√ºgen_von_2D_Inhalten_in_einen_WebGL-Kontext	/de/docs/Web/API/WebGL_API/Tutorial/Adding_2D_content_to_a_WebGL_context
/de/docs/Web/API/WebGL_API/Objekte_mit_WebGL_animieren	/de/docs/Web/API/WebGL_API/Tutorial/Animating_objects_with_WebGL
/de/docs/Web/API/WebGL_API/Texturen_in_WebGL_verwenden	/de/docs/Web/API/WebGL_API/Tutorial/Using_textures_in_WebGL
/de/docs/Web/API/WebGL_API/Tutorial/3D-Objekte_mit_WebGL_erstellen	/de/docs/Web/API/WebGL_API/Tutorial/Creating_3D_objects_using_WebGL
/de/docs/Web/API/WebGL_API/Tutorial/Animierte_Texturen_in_WebGL	/de/docs/Web/API/WebGL_API/Tutorial/Animating_textures_in_WebGL
/de/docs/Web/API/WebGL_API/Tutorial/Beleuchtung_in_WebGL	/de/docs/Web/API/WebGL_API/Tutorial/Lighting_in_WebGL
/de/docs/Web/API/WebGL_API/Tutorial/Einf√ºhrung_in_WebGL	/de/docs/Web/API/WebGL_API/Tutorial/Getting_started_with_WebGL
/de/docs/Web/API/WebGL_API/Tutorial/Farben_mittels_Shader_in_einen_WebGL-Kontext_hinzuf√ºgen	/de/docs/Web/API/WebGL_API/Tutorial/Using_shaders_to_apply_color_in_WebGL
/de/docs/Web/API/WebGL_API/Tutorial/Hinzuf√ºgen_von_2D_Inhalten_in_einen_WebGL-Kontext	/de/docs/Web/API/WebGL_API/Tutorial/Adding_2D_content_to_a_WebGL_context
/de/docs/Web/API/WebGL_API/Tutorial/Objekte_mit_WebGL_animieren	/de/docs/Web/API/WebGL_API/Tutorial/Animating_objects_with_WebGL
/de/docs/Web/API/WebGL_API/Tutorial/Texturen_in_WebGL_verwenden	/de/docs/Web/API/WebGL_API/Tutorial/Using_textures_in_WebGL
/de/docs/Web/API/Window.alert	/de/docs/Web/API/Window/alert
/de/docs/Web/API/Window/setTimeout	/de/docs/Web/API/WindowOrWorkerGlobalScope/setTimeout
/de/docs/Web/API/WindowBase64	/de/docs/Web/API/WindowOrWorkerGlobalScope
/de/docs/Web/API/WindowBase64/btoa	/de/docs/Web/API/WindowOrWorkerGlobalScope/btoa
/de/docs/Web/API/WindowTimers	/de/docs/conflicting/Web/API/WindowOrWorkerGlobalScope
/de/docs/Web/API/WindowTimers/setTimeout	/de/docs/Web/API/WindowOrWorkerGlobalScope/setTimeout
/de/docs/Web/API/document.documentElement	/de/docs/Web/API/Document/documentElement
/de/docs/Web/Barrierefreiheit	/de/docs/Web/Accessibility
/de/docs/Web/Barrierefreiheit/ARIA	/de/docs/Web/Accessibility/ARIA
/de/docs/Web/Barrierefreiheit/ARIA/ARIA_Live_Regionen	/de/docs/Web/Accessibility/ARIA/ARIA_Live_Regions
/de/docs/Web/Barrierefreiheit/ARIA/ARIA_Techniken	/de/docs/Web/Accessibility/ARIA/ARIA_Techniques
/de/docs/Web/Barrierefreiheit/An_overview_of_accessible_web_applications_and_widgets	/de/docs/Web/Accessibility/An_overview_of_accessible_web_applications_and_widgets
/de/docs/Web/Barrierefreiheit/Tastaturgesteuerte_JavaScript_Komponenten	/de/docs/Web/Accessibility/Keyboard-navigable_JavaScript_widgets
/de/docs/Web/Barrierefreiheit/Webentwicklung	/de/docs/conflicting/Web/Accessibility
/de/docs/Web/CSS/-moz-alias	/de/docs/Web/CSS/cursor
/de/docs/Web/CSS/-moz-appearance	/de/docs/Web/CSS/appearance
/de/docs/Web/CSS/-moz-background-inline-policy	/de/docs/Web/CSS/box-decoration-break
/de/docs/Web/CSS/-moz-border-radius	/de/docs/Web/CSS/border-radius
/de/docs/Web/CSS/-moz-border-radius-bottomleft	/de/docs/Web/CSS/border-bottom-left-radius
/de/docs/Web/CSS/-moz-border-radius-bottomright	/de/docs/Web/CSS/border-bottom-right-radius
/de/docs/Web/CSS/-moz-border-radius-topleft	/de/docs/Web/CSS/border-top-left-radius
/de/docs/Web/CSS/-moz-border-radius-topright	/de/docs/Web/CSS/border-top-right-radius
/de/docs/Web/CSS/-moz-box-flex	/de/docs/Web/CSS/box-flex
/de/docs/Web/CSS/-moz-box-ordinal-group	/de/docs/Web/CSS/box-ordinal-group
/de/docs/Web/CSS/-moz-box-pack	/de/docs/Web/CSS/box-pack
/de/docs/Web/CSS/-moz-box-shadow	/de/docs/Web/CSS/box-shadow
/de/docs/Web/CSS/-moz-cell	/de/docs/conflicting/Web/CSS/cursor
/de/docs/Web/CSS/-moz-context-menu	/de/docs/Web/CSS/cursor
/de/docs/Web/CSS/-moz-copy	/de/docs/Web/CSS/cursor
/de/docs/Web/CSS/-moz-spinning	/de/docs/Web/CSS/cursor
/de/docs/Web/CSS/-moz-user-modify	/de/docs/Web/CSS/user-modify
/de/docs/Web/CSS/-moz-user-select	/de/docs/Web/CSS/user-select
/de/docs/Web/CSS/-webkit-mask-origin	/de/docs/Web/CSS/mask-origin
/de/docs/Web/CSS/-webkit-mask-repeat	/de/docs/Web/CSS/mask-repeat
/de/docs/Web/CSS/:-moz-placeholder	/de/docs/Web/CSS/:placeholder-shown
/de/docs/Web/CSS/:-moz-ui-invalid	/de/docs/Web/CSS/:user-invalid
/de/docs/Web/CSS/:-webkit-autofill	/de/docs/Web/CSS/:autofill
/de/docs/Web/CSS/::-moz-placeholder	/de/docs/conflicting/Web/CSS/::placeholder
/de/docs/Web/CSS/Adjacent_sibling_selectors	/de/docs/Web/CSS/Adjacent_sibling_combinator
/de/docs/Web/CSS/Alias	/de/docs/conflicting/Web/CSS/cursor_35a62ea3f10b688a3a87ccfe07779743
/de/docs/Web/CSS/Angrenzende_Geschwisterselektoren	/de/docs/Web/CSS/Adjacent_sibling_combinator
/de/docs/Web/CSS/Attributselektoren	/de/docs/Web/CSS/Attribute_selectors
/de/docs/Web/CSS/Aural	/de/docs/Web/CSS/@media/aural
/de/docs/Web/CSS/Boxmodell	/de/docs/Web/CSS/CSS_Box_Model/Introduction_to_the_CSS_box_model
/de/docs/Web/CSS/CSS_Animations/CSS_Animationen_nutzen	/de/docs/Web/CSS/CSS_Animations/Using_CSS_animations
/de/docs/Web/CSS/CSS_Background_and_Borders	/de/docs/Web/CSS/CSS_Backgrounds_and_Borders
/de/docs/Web/CSS/CSS_Background_and_Borders/Mehrere_Hintergr√ºnde_in_CSS_verwenden	/de/docs/Web/CSS/CSS_Backgrounds_and_Borders/Using_multiple_backgrounds
/de/docs/Web/CSS/CSS_Box_Model/Box-shadow_generator	/de/docs/Web/CSS/CSS_Background_and_Borders/Box-shadow_generator
/de/docs/Web/CSS/CSS_Boxmodell	/de/docs/Web/CSS/CSS_Box_Model
/de/docs/Web/CSS/CSS_Boxmodell/Box-shadow_generator	/de/docs/Web/CSS/CSS_Background_and_Borders/Box-shadow_generator
/de/docs/Web/CSS/CSS_Boxmodell/Einf√ºhrung_in_das_CSS_Boxmodell	/de/docs/Web/CSS/CSS_Box_Model/Introduction_to_the_CSS_box_model
/de/docs/Web/CSS/CSS_Boxmodell/Zusammenfallen_von_Au√üenabst√§nden_meistern	/de/docs/Web/CSS/CSS_Box_Model/Mastering_margin_collapsing
/de/docs/Web/CSS/CSS_Colors	/de/docs/Web/CSS/CSS_Color
/de/docs/Web/CSS/CSS_Colors/farbauswahl_werkzeug	/de/docs/Web/CSS/CSS_Colors/Color_picker_tool
/de/docs/Web/CSS/CSS_Compositing_and_Blending	/de/docs/Web/CSS/Compositing_and_Blending
/de/docs/Web/CSS/CSS_Flexible_Box_Layout/Flex_Elemente_Sortieren	/de/docs/Web/CSS/CSS_Flexible_Box_Layout/Ordering_Flex_Items
/de/docs/Web/CSS/CSS_Flexible_Box_Layout/Grundlegende_Konzepte_der_Flexbox	/de/docs/Web/CSS/CSS_Flexible_Box_Layout/Basic_Concepts_of_Flexbox
/de/docs/Web/CSS/CSS_Flexible_Box_Layout/Using_CSS_flexible_boxes	/de/docs/conflicting/Web/CSS/CSS_Flexible_Box_Layout/Basic_Concepts_of_Flexbox
/de/docs/Web/CSS/CSS_Lists_and_Counters/CSS_Z√§hler_verwenden	/de/docs/Web/CSS/CSS_Lists_and_Counters/Using_CSS_counters
/de/docs/Web/CSS/CSS_Lists_and_Counters/Konsistente_Listeneinr√ºckung	/de/docs/Web/CSS/CSS_Lists_and_Counters/Consistent_list_indentation
/de/docs/Web/CSS/CSS_Masken	/de/docs/Web/CSS/CSS_Masking
/de/docs/Web/CSS/CSS_Namensr√§ume	/de/docs/Web/CSS/CSS_Namespaces
/de/docs/Web/CSS/CSS_Referenz	/de/docs/Web/CSS/Reference
/de/docs/Web/CSS/CSS_Referenz/::backdrop	/de/docs/Web/CSS/::backdrop
/de/docs/Web/CSS/CSS_Referenz/<basic-shape>	/de/docs/Web/CSS/basic-shape
/de/docs/Web/CSS/CSS_Referenz/@viewport	/de/docs/Web/CSS/@viewport
/de/docs/Web/CSS/CSS_Referenz/Mozilla_CSS_Erweiterungen	/de/docs/Web/CSS/Mozilla_Extensions
/de/docs/Web/CSS/CSS_Referenz/Webkit_Extensions	/de/docs/Web/CSS/WebKit_Extensions
/de/docs/Web/CSS/CSS_Referenz/line-break	/de/docs/Web/CSS/line-break
/de/docs/Web/CSS/CSS_Referenz/mix-blend-mode	/de/docs/Web/CSS/mix-blend-mode
/de/docs/Web/CSS/CSS_Textdekoration	/de/docs/Web/CSS/CSS_Text_Decoration
/de/docs/Web/CSS/CSS_Transforms/CSS_Transformationen_verwenden	/de/docs/Web/CSS/CSS_Transforms/Using_CSS_transforms
/de/docs/Web/CSS/CSS_Typen	/de/docs/Web/CSS/CSS_Types
/de/docs/Web/CSS/CSS_User_Interface	/de/docs/conflicting/Web/CSS/CSS_Basic_User_Interface
/de/docs/Web/CSS/CSS_Werte_Geltung	/de/docs/Web/CSS
/de/docs/Web/CSS/CSS_animierbare_Eigenschaften	/de/docs/Web/CSS
/de/docs/Web/CSS/CSS_prozentuale_werte	/de/docs/Web/CSS
/de/docs/Web/CSS/CSS_werte_syntax	/de/docs/Web/CSS
/de/docs/Web/CSS/Child_selectors	/de/docs/Web/CSS/Child_combinator
/de/docs/Web/CSS/Farben	/de/docs/Web/CSS/color_value
/de/docs/Web/CSS/Getting_Started	/de/docs/conflicting/Learn/CSS/First_steps
/de/docs/Web/CSS/ID-Selektoren	/de/docs/Web/CSS/ID_selectors
/de/docs/Web/CSS/Index	/de/docs/orphaned/Web/CSS/Index
/de/docs/Web/CSS/Initialwert	/de/docs/Web/CSS/initial_value
/de/docs/Web/CSS/Kindselektoren	/de/docs/Web/CSS/Child_combinator
/de/docs/Web/CSS/Klassenselektoren	/de/docs/Web/CSS/Class_selectors
/de/docs/Web/CSS/Kurzformat_Eigenschaft	/de/docs/Web/CSS/Shorthand_properties
/de/docs/Web/CSS/Motion_Path	/de/docs/Web/CSS/CSS_Motion_Path
/de/docs/Web/CSS/Property_Template	/de/docs/orphaned/MDN/Contribute/Howto/Document_a_CSS_property/Property_template
/de/docs/Web/CSS/Pseudoklasse	/de/docs/Web/CSS/Pseudo-classes
/de/docs/Web/CSS/Referenz	/de/docs/Web/CSS/Reference
/de/docs/Web/CSS/Spezifit√§t	/de/docs/Web/CSS/Specificity
/de/docs/Web/CSS/Vererbung	/de/docs/Web/CSS/inheritance
/de/docs/Web/CSS/Wertdefinitionssyntax	/de/docs/Web/CSS/Value_definition_syntax
/de/docs/Web/CSS/attr	/de/docs/Web/CSS/attr()
/de/docs/Web/CSS/auto	/de/docs/conflicting/Web/CSS/width
/de/docs/Web/CSS/berechneter_Wert	/de/docs/Web/CSS/computed_value
/de/docs/Web/CSS/calc	/de/docs/Web/CSS/calc()
/de/docs/Web/CSS/ersetztes_Element	/de/docs/Web/CSS/Replaced_element
/de/docs/Web/CSS/grid-gap	/de/docs/Web/CSS/gap
/de/docs/Web/CSS/hidden	/de/docs/Web/CSS/visibility
/de/docs/Web/CSS/linear-gradient	/de/docs/Web/CSS/linear-gradient()
/de/docs/Web/CSS/marks	/de/docs/Web/CSS/@page/marks
/de/docs/Web/CSS/mq-boolean	/de/docs/Web/CSS/Media_Queries/Using_media_queries
/de/docs/Web/CSS/none	/de/docs/conflicting/Web/CSS/float
/de/docs/Web/CSS/normal	/de/docs/conflicting/Web/CSS/font-variant
/de/docs/Web/CSS/tats√§chlicher_Wert	/de/docs/Web/CSS/actual_value
/de/docs/Web/CSS/url	/de/docs/Web/CSS/url()
/de/docs/Web/CSS/visible	/de/docs/Web/CSS/visibility
/de/docs/Web/CSS/word-wrap	/de/docs/Web/CSS/overflow-wrap
/de/docs/Web/Events/DOMContentLoaded	/de/docs/Web/API/Window/DOMContentLoaded_event
/de/docs/Web/Events/change	/de/docs/Web/API/HTMLElement/change_event
/de/docs/Web/Events/fullscreenchange	/de/docs/Web/API/Document/fullscreenchange_event
/de/docs/Web/Events/load	/de/docs/Web/API/Window/load_event
/de/docs/Web/Events/readystatechange	/de/docs/Web/API/Document/readystatechange_event
/de/docs/Web/Events/submit	/de/docs/Web/API/HTMLFormElement/submit_event
/de/docs/Web/Events/webglcontextcreationerror	/de/docs/Web/API/HTMLCanvasElement/webglcontextcreationerror_event
/de/docs/Web/Events/webglcontextlost	/de/docs/Web/API/HTMLCanvasElement/webglcontextlost_event
/de/docs/Web/Events/webglcontextrestored	/de/docs/Web/API/HTMLCanvasElement/webglcontextrestored_event
/de/docs/Web/Guide/AJAX/Erste_Schritte	/de/docs/Web/Guide/AJAX/Getting_Started
/de/docs/Web/Guide/CSS	/de/docs/Learn/CSS
/de/docs/Web/Guide/CSS/CSS_Animationen_nutzen	/de/docs/Web/CSS/CSS_Animations/Using_CSS_animations
/de/docs/Web/Guide/CSS/Flexible_boxes	/de/docs/conflicting/Web/CSS/CSS_Flexible_Box_Layout/Basic_Concepts_of_Flexbox
/de/docs/Web/Guide/CSS/Getting_started	/de/docs/conflicting/Learn/CSS/First_steps
/de/docs/Web/Guide/CSS/Getting_started/Farbe	/de/docs/conflicting/Learn/CSS/Building_blocks/Values_and_units
/de/docs/Web/Guide/CSS/Getting_started/Kaskadierung_und_vererbung	/de/docs/Learn/CSS/Building_blocks/Cascade_and_inheritance
/de/docs/Web/Guide/CSS/Getting_started/Lesbares_CSS	/de/docs/Learn/CSS/First_steps/How_CSS_is_structured
/de/docs/Web/Guide/CSS/Getting_started/Selektoren	/de/docs/Learn/CSS/Building_blocks/Selectors
/de/docs/Web/Guide/CSS/Getting_started/Textstyles	/de/docs/Learn/CSS/Styling_text/Fundamentals
/de/docs/Web/Guide/CSS/Getting_started/Was_ist_CSS	/de/docs/Learn/CSS/First_steps/How_CSS_works
/de/docs/Web/Guide/CSS/Getting_started/Why_use_CSS	/de/docs/conflicting/Learn/CSS/First_steps/How_CSS_works
/de/docs/Web/Guide/CSS/Getting_started/Wie_CSS_funktioniert	/de/docs/conflicting/Learn/CSS/First_steps/How_CSS_works_0e31d13696060558e208fc6c734ae400
/de/docs/Web/Guide/CSS/Scaling_background_images	/de/docs/Web/CSS/CSS_Backgrounds_and_Borders/Resizing_background_images
/de/docs/Web/Guide/CSS/mehrere_Hintergr√ºnde_verwenden	/de/docs/Web/CSS/CSS_Backgrounds_and_Borders/Using_multiple_backgrounds
/de/docs/Web/Guide/DOM	/de/docs/conflicting/Web/API/Document_Object_Model_656f0e51418b39c498011268be9b3a10
/de/docs/Web/Guide/DOM/Manipulating_the_browser_history	/de/docs/Web/API/History_API
/de/docs/Web/Guide/HTML	/de/docs/Learn/HTML
/de/docs/Web/Guide/HTML/Canvas_Tutorial	/de/docs/Web/API/Canvas_API/Tutorial
/de/docs/Web/Guide/HTML/Canvas_Tutorial/Advanced_animations	/de/docs/Web/API/Canvas_API/Tutorial/Advanced_animations
/de/docs/Web/Guide/HTML/Canvas_Tutorial/Applying_styles_and_colors	/de/docs/Web/API/Canvas_API/Tutorial/Applying_styles_and_colors
/de/docs/Web/Guide/HTML/Canvas_Tutorial/Basic_animations	/de/docs/Web/API/Canvas_API/Tutorial/Basic_animations
/de/docs/Web/Guide/HTML/Canvas_Tutorial/Bilder	/de/docs/Web/API/Canvas_API/Tutorial/Using_images
/de/docs/Web/Guide/HTML/Canvas_Tutorial/Canvas_optimieren	/de/docs/Web/API/Canvas_API/Tutorial/Optimizing_canvas
/de/docs/Web/Guide/HTML/Canvas_Tutorial/Drawing_text	/de/docs/Web/API/Canvas_API/Tutorial/Drawing_text
/de/docs/Web/Guide/HTML/Canvas_Tutorial/Formen_zeichnen	/de/docs/Web/API/Canvas_API/Tutorial/Drawing_shapes
/de/docs/Web/Guide/HTML/Canvas_Tutorial/Grundlagen	/de/docs/Web/API/Canvas_API/Tutorial/Basic_usage
/de/docs/Web/Guide/HTML/Content_Editable	/de/docs/Web/Guide/HTML/Editable_content
/de/docs/Web/Guide/HTML/Einf√ºhrung	/de/docs/Learn/HTML/Introduction_to_HTML
/de/docs/Web/Guide/HTML/Inhaltskategorien	/de/docs/Web/Guide/HTML/Content_categories
/de/docs/Web/Guide/HTML/Sections_and_Outlines_of_an_HTML5_document	/de/docs/Web/Guide/HTML/Using_HTML_sections_and_outlines
/de/docs/Web/HTML/Block-level_elemente	/de/docs/Web/HTML/Block-level_elements
/de/docs/Web/HTML/Canvas	/de/docs/Web/API/Canvas_API
/de/docs/Web/HTML/Element/h1	/de/docs/Web/HTML/Element/Heading_Elements
/de/docs/Web/HTML/Element/h1-h6	/de/docs/Web/HTML/Element/Heading_Elements
/de/docs/Web/HTML/Element/h2	/de/docs/Web/HTML/Element/Heading_Elements
/de/docs/Web/HTML/Element/h3	/de/docs/Web/HTML/Element/Heading_Elements
/de/docs/Web/HTML/Element/h4	/de/docs/Web/HTML/Element/Heading_Elements
/de/docs/Web/HTML/Element/h5	/de/docs/Web/HTML/Element/Heading_Elements
/de/docs/Web/HTML/Element/h6	/de/docs/Web/HTML/Element/Heading_Elements
/de/docs/Web/HTML/Element/head	/de/docs/Web/API/HTMLHeadElement
/de/docs/Web/HTML/Globale_Attribute	/de/docs/Web/HTML/Global_attributes
/de/docs/Web/HTML/Globale_Attribute/accesskey	/de/docs/Web/HTML/Global_attributes/accesskey
/de/docs/Web/HTML/Globale_Attribute/autocapitalize	/de/docs/Web/HTML/Global_attributes/autocapitalize
/de/docs/Web/HTML/Globale_Attribute/class	/de/docs/Web/HTML/Global_attributes/class
/de/docs/Web/HTML/Globale_Attribute/contenteditable	/de/docs/Web/HTML/Global_attributes/contenteditable
/de/docs/Web/HTML/Globale_Attribute/dir	/de/docs/Web/HTML/Global_attributes/dir
/de/docs/Web/HTML/Globale_Attribute/draggable	/de/docs/Web/HTML/Global_attributes/draggable
/de/docs/Web/HTML/Globale_Attribute/dropzone	/de/docs/orphaned/Web/HTML/Global_attributes/dropzone
/de/docs/Web/HTML/Globale_Attribute/hidden	/de/docs/Web/HTML/Global_attributes/hidden
/de/docs/Web/HTML/Globale_Attribute/id	/de/docs/Web/HTML/Global_attributes/id
/de/docs/Web/HTML/Globale_Attribute/inputmode	/de/docs/Web/HTML/Global_attributes/inputmode
/de/docs/Web/HTML/Globale_Attribute/is	/de/docs/Web/HTML/Global_attributes/is
/de/docs/Web/HTML/Globale_Attribute/kontextmenu	/de/docs/Web/HTML/Global_attributes/contextmenu
/de/docs/Web/HTML/Globale_Attribute/lang	/de/docs/Web/HTML/Global_attributes/lang
/de/docs/Web/HTML/Globale_Attribute/style	/de/docs/Web/HTML/Global_attributes/style
/de/docs/Web/HTML/Globale_Attribute/tabindex	/de/docs/Web/HTML/Global_attributes/tabindex
/de/docs/Web/HTML/Globale_Attribute/title	/de/docs/Web/HTML/Global_attributes/title
/de/docs/Web/HTML/Globale_Attribute/translate	/de/docs/Web/HTML/Global_attributes/translate
/de/docs/Web/HTML/HTML5	/de/docs/Web/Guide/HTML/HTML5
/de/docs/Web/HTML/HTML5/HTML5_element_list	/de/docs/conflicting/Web/HTML/Element
/de/docs/Web/HTML/Inline_elemente	/de/docs/Web/HTML/Inline_elements
/de/docs/Web/HTML/Referenz	/de/docs/Web/HTML/Reference
/de/docs/Web/HTTP/CORS/Errors/CORSFehlenderAllowHeaderAusPreflight	/de/docs/Web/HTTP/CORS/Errors/CORSMissingAllowHeaderFromPreflight
/de/docs/Web/HTTP/CORS/Errors/CORSFehltQuelleErlauben	/de/docs/Web/HTTP/CORS/Errors/CORSMissingAllowOrigin
/de/docs/Web/HTTP/Caching_FAQ	/de/docs/Web/HTTP/Caching
/de/docs/Web/JavaScript/Aufz√§hlbarkeit_und_Zugeh√∂rigkeit_von_Eigenschaften	/de/docs/Web/JavaScript/Enumerability_and_ownership_of_properties
/de/docs/Web/JavaScript/Datenstrukturen	/de/docs/Web/JavaScript/Data_structures
/de/docs/Web/JavaScript/Datenstruktures	/de/docs/Web/JavaScript/Data_structures
/de/docs/Web/JavaScript/Eine_Wiedereinfuehrung_in_JavaScript	/de/docs/Web/JavaScript/A_re-introduction_to_JavaScript
/de/docs/Web/JavaScript/Einf√ºhrung_in_den_Gebrauch_von_XPath_in_JavaScript	/de/docs/Web/XPath/Introduction_to_using_XPath_in_JavaScript
/de/docs/Web/JavaScript/Guide/Ausdruecke_und_Operatoren	/de/docs/Web/JavaScript/Guide/Expressions_and_Operators
/de/docs/Web/JavaScript/Guide/Closures	/de/docs/Web/JavaScript/Closures
/de/docs/Web/JavaScript/Guide/Einf√ºhrung	/de/docs/Web/JavaScript/Guide/Introduction
/de/docs/Web/JavaScript/Guide/Feinheiten_des_Objektmodells	/de/docs/Web/JavaScript/Guide/Details_of_the_Object_Model
/de/docs/Web/JavaScript/Guide/Funktionen	/de/docs/Web/JavaScript/Guide/Functions
/de/docs/Web/JavaScript/Guide/Grammatik_und_Typen	/de/docs/Web/JavaScript/Guide/Grammar_and_types
/de/docs/Web/JavaScript/Guide/Kontrollfluss_und_Fehlerbehandlung	/de/docs/Web/JavaScript/Guide/Control_flow_and_error_handling
/de/docs/Web/JavaScript/Guide/Mit_Objekten_arbeiten	/de/docs/Web/JavaScript/Guide/Working_with_Objects
/de/docs/Web/JavaScript/Guide/Statements	/de/docs/Web/JavaScript/Guide/Control_flow_and_error_handling
/de/docs/Web/JavaScript/Guide/Textformatierung	/de/docs/Web/JavaScript/Guide/Text_formatting
/de/docs/Web/JavaScript/Guide/Ueber_JavaScript	/de/docs/Web/JavaScript/Guide/Introduction
/de/docs/Web/JavaScript/Guide/Ueber_diese_Einfuehrung	/de/docs/Web/JavaScript/Guide/Introduction
/de/docs/Web/JavaScript/Guide/Vererbung_ueberdacht	/de/docs/Web/JavaScript/Inheritance_and_the_prototype_chain
/de/docs/Web/JavaScript/Guide/Vergleiche_auf_Gleichheit_und_deren_Verwendung	/de/docs/Web/JavaScript/Equality_comparisons_and_sameness
/de/docs/Web/JavaScript/Guide/Vordefinierte_Kernobjekte	/de/docs/Web/JavaScript/Guide
/de/docs/Web/JavaScript/Guide/Werte_Variablen_und_Literale	/de/docs/Web/JavaScript/Guide/Grammar_and_types
/de/docs/Web/JavaScript/Guide/schleifen_und_iterationen	/de/docs/Web/JavaScript/Guide/Loops_and_iteration
/de/docs/Web/JavaScript/Guide/√úber_Javascript	/de/docs/Web/JavaScript/Guide/Introduction
/de/docs/Web/JavaScript/Guide/√úber_diese_Einf√ºhrung	/de/docs/Web/JavaScript/Guide/Introduction
/de/docs/Web/JavaScript/Introduction_to_Object-Oriented_JavaScript	/de/docs/conflicting/Learn/JavaScript/Objects
/de/docs/Web/JavaScript/JavaScript_technologieuebersicht	/de/docs/Web/JavaScript/JavaScript_technologies_overview
/de/docs/Web/JavaScript/Javascript_lernen_f√ºr_Anf√§nger	/de/docs/Web/JavaScript/Guide
/de/docs/Web/JavaScript/Reference/Anweisungen	/de/docs/Web/JavaScript/Reference/Statements
/de/docs/Web/JavaScript/Reference/Anweisungen/const	/de/docs/Web/JavaScript/Reference/Statements/const
/de/docs/Web/JavaScript/Reference/Anweisungen/for...in	/de/docs/Web/JavaScript/Reference/Statements/for...in
/de/docs/Web/JavaScript/Reference/Anweisungen/let	/de/docs/Web/JavaScript/Reference/Statements/let
/de/docs/Web/JavaScript/Reference/Anweisungen/var	/de/docs/Web/JavaScript/Reference/Statements/var
/de/docs/Web/JavaScript/Reference/Fehler	/de/docs/Web/JavaScript/Reference/Errors
/de/docs/Web/JavaScript/Reference/Fehler/Already_has_pragma	/de/docs/Web/JavaScript/Reference/Errors/Already_has_pragma
/de/docs/Web/JavaScript/Reference/Fehler/Array_sort_argument	/de/docs/Web/JavaScript/Reference/Errors/Array_sort_argument
/de/docs/Web/JavaScript/Reference/Fehler/Bad_octal	/de/docs/Web/JavaScript/Reference/Errors/Bad_octal
/de/docs/Web/JavaScript/Reference/Fehler/Bad_radix	/de/docs/Web/JavaScript/Reference/Errors/Bad_radix
/de/docs/Web/JavaScript/Reference/Fehler/Bad_regexp_flag	/de/docs/Web/JavaScript/Reference/Errors/Bad_regexp_flag
/de/docs/Web/JavaScript/Reference/Fehler/Bad_return_or_yield	/de/docs/Web/JavaScript/Reference/Errors/Bad_return_or_yield
/de/docs/Web/JavaScript/Reference/Fehler/Called_on_incompatible_type	/de/docs/Web/JavaScript/Reference/Errors/Called_on_incompatible_type
/de/docs/Web/JavaScript/Reference/Fehler/Cant_access_lexical_declaration_before_init	/de/docs/Web/JavaScript/Reference/Errors/Cant_access_lexical_declaration_before_init
/de/docs/Web/JavaScript/Reference/Fehler/Cant_access_property	/de/docs/Web/JavaScript/Reference/Errors/Cant_access_property
/de/docs/Web/JavaScript/Reference/Fehler/Cant_define_property_object_not_extensible	/de/docs/Web/JavaScript/Reference/Errors/Cant_define_property_object_not_extensible
/de/docs/Web/JavaScript/Reference/Fehler/Cant_delete	/de/docs/Web/JavaScript/Reference/Errors/Cant_delete
/de/docs/Web/JavaScript/Reference/Fehler/Cant_redefine_property	/de/docs/Web/JavaScript/Reference/Errors/Cant_redefine_property
/de/docs/Web/JavaScript/Reference/Fehler/Cyclic_object_value	/de/docs/Web/JavaScript/Reference/Errors/Cyclic_object_value
/de/docs/Web/JavaScript/Reference/Fehler/Dead_object	/de/docs/Web/JavaScript/Reference/Errors/Dead_object
/de/docs/Web/JavaScript/Reference/Fehler/Delete_in_strict_mode	/de/docs/Web/JavaScript/Reference/Errors/Delete_in_strict_mode
/de/docs/Web/JavaScript/Reference/Fehler/Deprecated_String_generics	/de/docs/Web/JavaScript/Reference/Errors/Deprecated_String_generics
/de/docs/Web/JavaScript/Reference/Fehler/Deprecated_caller_or_arguments_usage	/de/docs/Web/JavaScript/Reference/Errors/Deprecated_caller_or_arguments_usage
/de/docs/Web/JavaScript/Reference/Fehler/Deprecated_expression_closures	/de/docs/Web/JavaScript/Reference/Errors/Deprecated_expression_closures
/de/docs/Web/JavaScript/Reference/Fehler/Deprecated_octal	/de/docs/Web/JavaScript/Reference/Errors/Deprecated_octal
/de/docs/Web/JavaScript/Reference/Fehler/Deprecated_source_map_pragma	/de/docs/Web/JavaScript/Reference/Errors/Deprecated_source_map_pragma
/de/docs/Web/JavaScript/Reference/Fehler/Deprecated_toLocaleFormat	/de/docs/Web/JavaScript/Reference/Errors/Deprecated_toLocaleFormat
/de/docs/Web/JavaScript/Reference/Fehler/Equal_as_assign	/de/docs/Web/JavaScript/Reference/Errors/Equal_as_assign
/de/docs/Web/JavaScript/Reference/Fehler/For-each-in_loops_are_deprecated	/de/docs/Web/JavaScript/Reference/Errors/For-each-in_loops_are_deprecated
/de/docs/Web/JavaScript/Reference/Fehler/Getter_only	/de/docs/Web/JavaScript/Reference/Errors/Getter_only
/de/docs/Web/JavaScript/Reference/Fehler/Identifier_after_number	/de/docs/Web/JavaScript/Reference/Errors/Identifier_after_number
/de/docs/Web/JavaScript/Reference/Fehler/Illegal_character	/de/docs/Web/JavaScript/Reference/Errors/Illegal_character
/de/docs/Web/JavaScript/Reference/Fehler/Invalid_array_length	/de/docs/Web/JavaScript/Reference/Errors/Invalid_array_length
/de/docs/Web/JavaScript/Reference/Fehler/Invalid_assignment_left-hand_side	/de/docs/Web/JavaScript/Reference/Errors/Invalid_assignment_left-hand_side
/de/docs/Web/JavaScript/Reference/Fehler/Invalid_const_assignment	/de/docs/Web/JavaScript/Reference/Errors/Invalid_const_assignment
/de/docs/Web/JavaScript/Reference/Fehler/Invalid_date	/de/docs/Web/JavaScript/Reference/Errors/Invalid_date
/de/docs/Web/JavaScript/Reference/Fehler/Invalid_for-in_initializer	/de/docs/Web/JavaScript/Reference/Errors/Invalid_for-in_initializer
/de/docs/Web/JavaScript/Reference/Fehler/Invalid_for-of_initializer	/de/docs/Web/JavaScript/Reference/Errors/Invalid_for-of_initializer
/de/docs/Web/JavaScript/Reference/Fehler/JSON_bad_parse	/de/docs/Web/JavaScript/Reference/Errors/JSON_bad_parse
/de/docs/Web/JavaScript/Reference/Fehler/Malformed_URI	/de/docs/Web/JavaScript/Reference/Errors/Malformed_URI
/de/docs/Web/JavaScript/Reference/Fehler/Malformed_formal_parameter	/de/docs/Web/JavaScript/Reference/Errors/Malformed_formal_parameter
/de/docs/Web/JavaScript/Reference/Fehler/Missing_bracket_after_list	/de/docs/Web/JavaScript/Reference/Errors/Missing_bracket_after_list
/de/docs/Web/JavaScript/Reference/Fehler/Missing_colon_after_property_id	/de/docs/Web/JavaScript/Reference/Errors/Missing_colon_after_property_id
/de/docs/Web/JavaScript/Reference/Fehler/Missing_curly_after_function_body	/de/docs/Web/JavaScript/Reference/Errors/Missing_curly_after_function_body
/de/docs/Web/JavaScript/Reference/Fehler/Missing_curly_after_property_list	/de/docs/Web/JavaScript/Reference/Errors/Missing_curly_after_property_list
/de/docs/Web/JavaScript/Reference/Fehler/Missing_formal_parameter	/de/docs/Web/JavaScript/Reference/Errors/Missing_formal_parameter
/de/docs/Web/JavaScript/Reference/Fehler/Missing_initializer_in_const	/de/docs/Web/JavaScript/Reference/Errors/Missing_initializer_in_const
/de/docs/Web/JavaScript/Reference/Fehler/Missing_name_after_dot_operator	/de/docs/Web/JavaScript/Reference/Errors/Missing_name_after_dot_operator
/de/docs/Web/JavaScript/Reference/Fehler/Missing_parenthesis_after_argument_list	/de/docs/Web/JavaScript/Reference/Errors/Missing_parenthesis_after_argument_list
/de/docs/Web/JavaScript/Reference/Fehler/Missing_parenthesis_after_condition	/de/docs/Web/JavaScript/Reference/Errors/Missing_parenthesis_after_condition
/de/docs/Web/JavaScript/Reference/Fehler/Missing_semicolon_before_statement	/de/docs/Web/JavaScript/Reference/Errors/Missing_semicolon_before_statement
/de/docs/Web/JavaScript/Reference/Fehler/More_arguments_needed	/de/docs/Web/JavaScript/Reference/Errors/More_arguments_needed
/de/docs/Web/JavaScript/Reference/Fehler/Negative_repetition_count	/de/docs/Web/JavaScript/Reference/Errors/Negative_repetition_count
/de/docs/Web/JavaScript/Reference/Fehler/No_non-null_object	/de/docs/Web/JavaScript/Reference/Errors/No_non-null_object
/de/docs/Web/JavaScript/Reference/Fehler/No_properties	/de/docs/Web/JavaScript/Reference/Errors/No_properties
/de/docs/Web/JavaScript/Reference/Fehler/No_variable_name	/de/docs/Web/JavaScript/Reference/Errors/No_variable_name
/de/docs/Web/JavaScript/Reference/Fehler/Non_configurable_array_element	/de/docs/Web/JavaScript/Reference/Errors/Non_configurable_array_element
/de/docs/Web/JavaScript/Reference/Fehler/Not_a_codepoint	/de/docs/Web/JavaScript/Reference/Errors/Not_a_codepoint
/de/docs/Web/JavaScript/Reference/Fehler/Not_a_constructor	/de/docs/Web/JavaScript/Reference/Errors/Not_a_constructor
/de/docs/Web/JavaScript/Reference/Fehler/Not_a_function	/de/docs/Web/JavaScript/Reference/Errors/Not_a_function
/de/docs/Web/JavaScript/Reference/Fehler/Not_defined	/de/docs/Web/JavaScript/Reference/Errors/Not_defined
/de/docs/Web/JavaScript/Reference/Fehler/Precision_range	/de/docs/Web/JavaScript/Reference/Errors/Precision_range
/de/docs/Web/JavaScript/Reference/Fehler/Property_access_denied	/de/docs/Web/JavaScript/Reference/Errors/Property_access_denied
/de/docs/Web/JavaScript/Reference/Fehler/Read-only	/de/docs/Web/JavaScript/Reference/Errors/Read-only
/de/docs/Web/JavaScript/Reference/Fehler/Redeclared_parameter	/de/docs/Web/JavaScript/Reference/Errors/Redeclared_parameter
/de/docs/Web/JavaScript/Reference/Fehler/Reduce_of_empty_array_with_no_initial_value	/de/docs/Web/JavaScript/Reference/Errors/Reduce_of_empty_array_with_no_initial_value
/de/docs/Web/JavaScript/Reference/Fehler/Reserved_identifier	/de/docs/Web/JavaScript/Reference/Errors/Reserved_identifier
/de/docs/Web/JavaScript/Reference/Fehler/Resulting_string_too_large	/de/docs/Web/JavaScript/Reference/Errors/Resulting_string_too_large
/de/docs/Web/JavaScript/Reference/Fehler/Stmt_after_return	/de/docs/Web/JavaScript/Reference/Errors/Stmt_after_return
/de/docs/Web/JavaScript/Reference/Fehler/Strict_Non_Simple_Params	/de/docs/Web/JavaScript/Reference/Errors/Strict_Non_Simple_Params
/de/docs/Web/JavaScript/Reference/Fehler/Too_much_recursion	/de/docs/Web/JavaScript/Reference/Errors/Too_much_recursion
/de/docs/Web/JavaScript/Reference/Fehler/Typed_array_invalid_arguments	/de/docs/Web/JavaScript/Reference/Errors/Typed_array_invalid_arguments
/de/docs/Web/JavaScript/Reference/Fehler/Undeclared_var	/de/docs/Web/JavaScript/Reference/Errors/Undeclared_var
/de/docs/Web/JavaScript/Reference/Fehler/Undefined_prop	/de/docs/Web/JavaScript/Reference/Errors/Undefined_prop
/de/docs/Web/JavaScript/Reference/Fehler/Unexpected_token	/de/docs/Web/JavaScript/Reference/Errors/Unexpected_token
/de/docs/Web/JavaScript/Reference/Fehler/Unexpected_type	/de/docs/Web/JavaScript/Reference/Errors/Unexpected_type
/de/docs/Web/JavaScript/Reference/Fehler/Unnamed_function_statement	/de/docs/Web/JavaScript/Reference/Errors/Unnamed_function_statement
/de/docs/Web/JavaScript/Reference/Fehler/Unterminated_string_literal	/de/docs/Web/JavaScript/Reference/Errors/Unterminated_string_literal
/de/docs/Web/JavaScript/Reference/Fehler/Var_hides_argument	/de/docs/Web/JavaScript/Reference/Errors/Var_hides_argument
/de/docs/Web/JavaScript/Reference/Fehler/in_operator_no_object	/de/docs/Web/JavaScript/Reference/Errors/in_operator_no_object
/de/docs/Web/JavaScript/Reference/Fehler/invalid_right_hand_side_instanceof_operand	/de/docs/Web/JavaScript/Reference/Errors/invalid_right_hand_side_instanceof_operand
/de/docs/Web/JavaScript/Reference/Fehler/is_not_iterable	/de/docs/Web/JavaScript/Reference/Errors/is_not_iterable
/de/docs/Web/JavaScript/Reference/Functions/Methoden_Definitionen	/de/docs/Web/JavaScript/Reference/Functions/Method_definitions
/de/docs/Web/JavaScript/Reference/Functions/Pfeilfunktionen	/de/docs/Web/JavaScript/Reference/Functions/Arrow_functions
/de/docs/Web/JavaScript/Reference/Functions/rest_parameter	/de/docs/Web/JavaScript/Reference/Functions/rest_parameters
/de/docs/Web/JavaScript/Reference/Global_Objects/Array/Prototypen	/de/docs/orphaned/Web/JavaScript/Reference/Global_Objects/Array/prototype
/de/docs/Web/JavaScript/Reference/Global_Objects/Array/flatten	/de/docs/Web/JavaScript/Reference/Global_Objects/Array/flat
/de/docs/Web/JavaScript/Reference/Global_Objects/ArrayBuffer/prototype	/de/docs/conflicting/Web/JavaScript/Reference/Global_Objects/ArrayBuffer
/de/docs/Web/JavaScript/Reference/Global_Objects/AsyncFunction/prototype	/de/docs/orphaned/Web/JavaScript/Reference/Global_Objects/AsyncFunction/prototype
/de/docs/Web/JavaScript/Reference/Global_Objects/Atomics/wake	/de/docs/Web/JavaScript/Reference/Global_Objects/Atomics/notify
/de/docs/Web/JavaScript/Reference/Global_Objects/Boolean/prototype	/de/docs/conflicting/Web/JavaScript/Reference/Global_Objects/Boolean
/de/docs/Web/JavaScript/Reference/Global_Objects/Collator	/de/docs/Web/JavaScript/Reference/Global_Objects/Intl/Collator
/de/docs/Web/JavaScript/Reference/Global_Objects/Collator/compare	/de/docs/Web/JavaScript/Reference/Global_Objects/Intl/Collator/compare
/de/docs/Web/JavaScript/Reference/Global_Objects/Collator/prototype	/de/docs/conflicting/Web/JavaScript/Reference/Global_Objects/Intl/Collator
/de/docs/Web/JavaScript/Reference/Global_Objects/Collator/resolvedOptions	/de/docs/Web/JavaScript/Reference/Global_Objects/Intl/Collator/resolvedOptions
/de/docs/Web/JavaScript/Reference/Global_Objects/Collator/supportedLocalesOf	/de/docs/Web/JavaScript/Reference/Global_Objects/Intl/Collator/supportedLocalesOf
/de/docs/Web/JavaScript/Reference/Global_Objects/DataView/prototype	/de/docs/conflicting/Web/JavaScript/Reference/Global_Objects/DataView
/de/docs/Web/JavaScript/Reference/Global_Objects/Date/prototype	/de/docs/conflicting/Web/JavaScript/Reference/Global_Objects/Date
/de/docs/Web/JavaScript/Reference/Global_Objects/DateTimeFormat	/de/docs/Web/JavaScript/Reference/Global_Objects/Intl/DateTimeFormat
/de/docs/Web/JavaScript/Reference/Global_Objects/DateTimeFormat/format	/de/docs/Web/JavaScript/Reference/Global_Objects/Intl/DateTimeFormat/format
/de/docs/Web/JavaScript/Reference/Global_Objects/DateTimeFormat/formatToParts	/de/docs/Web/JavaScript/Reference/Global_Objects/Intl/DateTimeFormat/formatToParts
/de/docs/Web/JavaScript/Reference/Global_Objects/DateTimeFormat/prototype	/de/docs/conflicting/Web/JavaScript/Reference/Global_Objects/Intl/DateTimeFormat
/de/docs/Web/JavaScript/Reference/Global_Objects/DateTimeFormat/resolvedOptions	/de/docs/Web/JavaScript/Reference/Global_Objects/Intl/DateTimeFormat/resolvedOptions
/de/docs/Web/JavaScript/Reference/Global_Objects/DateTimeFormat/supportedLocalesOf	/de/docs/Web/JavaScript/Reference/Global_Objects/Intl/DateTimeFormat/supportedLocalesOf
/de/docs/Web/JavaScript/Reference/Global_Objects/Error/prototype	/de/docs/conflicting/Web/JavaScript/Reference/Global_Objects/Error
/de/docs/Web/JavaScript/Reference/Global_Objects/EvalError/prototype	/de/docs/conflicting/Web/JavaScript/Reference/Global_Objects/EvalError
/de/docs/Web/JavaScript/Reference/Global_Objects/Function/prototype	/de/docs/conflicting/Web/JavaScript/Reference/Global_Objects/Function
/de/docs/Web/JavaScript/Reference/Global_Objects/GeneratorFunction/prototype	/de/docs/conflicting/Web/JavaScript/Reference/Global_Objects/GeneratorFunction
/de/docs/Web/JavaScript/Reference/Global_Objects/InternalError/prototype	/de/docs/conflicting/Web/JavaScript/Reference/Global_Objects/InternalError
/de/docs/Web/JavaScript/Reference/Global_Objects/Intl/Collator/prototype	/de/docs/conflicting/Web/JavaScript/Reference/Global_Objects/Intl/Collator
/de/docs/Web/JavaScript/Reference/Global_Objects/Intl/DateTimeFormat/prototype	/de/docs/conflicting/Web/JavaScript/Reference/Global_Objects/Intl/DateTimeFormat
/de/docs/Web/JavaScript/Reference/Global_Objects/Intl/NumberFormat/prototype	/de/docs/conflicting/Web/JavaScript/Reference/Global_Objects/Intl/NumberFormat
/de/docs/Web/JavaScript/Reference/Global_Objects/Map/prototype	/de/docs/conflicting/Web/JavaScript/Reference/Global_Objects/Map
/de/docs/Web/JavaScript/Reference/Global_Objects/Math/math.random	/de/docs/Web/JavaScript/Reference/Global_Objects/Math/random
/de/docs/Web/JavaScript/Reference/Global_Objects/Number/prototype	/de/docs/conflicting/Web/JavaScript/Reference/Global_Objects/Number
/de/docs/Web/JavaScript/Reference/Global_Objects/NumberFormat	/de/docs/Web/JavaScript/Reference/Global_Objects/Intl/NumberFormat
/de/docs/Web/JavaScript/Reference/Global_Objects/NumberFormat/format	/de/docs/Web/JavaScript/Reference/Global_Objects/Intl/NumberFormat/format
/de/docs/Web/JavaScript/Reference/Global_Objects/NumberFormat/prototype	/de/docs/conflicting/Web/JavaScript/Reference/Global_Objects/Intl/NumberFormat
/de/docs/Web/JavaScript/Reference/Global_Objects/NumberFormat/supportedLocalesOf	/de/docs/Web/JavaScript/Reference/Global_Objects/Intl/NumberFormat/supportedLocalesOf
/de/docs/Web/JavaScript/Reference/Global_Objects/Object/prototype	/de/docs/conflicting/Web/JavaScript/Reference/Global_Objects/Object
/de/docs/Web/JavaScript/Reference/Global_Objects/PluralRules	/de/docs/Web/JavaScript/Reference/Global_Objects/Intl/PluralRules
/de/docs/Web/JavaScript/Reference/Global_Objects/PluralRules/supportedLocalesOf	/de/docs/Web/JavaScript/Reference/Global_Objects/Intl/PluralRules/supportedLocalesOf
/de/docs/Web/JavaScript/Reference/Global_Objects/RangeError/prototype	/de/docs/conflicting/Web/JavaScript/Reference/Global_Objects/RangeError
/de/docs/Web/JavaScript/Reference/Global_Objects/String/TrimLeft	/de/docs/Web/JavaScript/Reference/Global_Objects/String/trimStart
/de/docs/Web/JavaScript/Reference/Global_Objects/String/TrimRight	/de/docs/Web/JavaScript/Reference/Global_Objects/String/trimEnd
/de/docs/Web/JavaScript/Reference/Global_Objects/String/prototype	/de/docs/conflicting/Web/JavaScript/Reference/Global_Objects/String
/de/docs/Web/JavaScript/Reference/Global_Objects/String/suchen	/de/docs/Web/JavaScript/Reference/Global_Objects/String/search
/de/docs/Web/JavaScript/Reference/Global_Objects/SyntaxError/prototype	/de/docs/conflicting/Web/JavaScript/Reference/Global_Objects/SyntaxError
/de/docs/Web/JavaScript/Reference/Global_Objects/TypeError/prototype	/de/docs/conflicting/Web/JavaScript/Reference/Global_Objects/TypeError
/de/docs/Web/JavaScript/Reference/Klassen	/de/docs/Web/JavaScript/Reference/Classes
/de/docs/Web/JavaScript/Reference/Klassen/constructor	/de/docs/Web/JavaScript/Reference/Classes/constructor
/de/docs/Web/JavaScript/Reference/Klassen/extends	/de/docs/Web/JavaScript/Reference/Classes/extends
/de/docs/Web/JavaScript/Reference/Klassen/static	/de/docs/Web/JavaScript/Reference/Classes/static
/de/docs/Web/JavaScript/Reference/Methods_Index	/de/docs/Web/JavaScript/Reference
/de/docs/Web/JavaScript/Reference/Operators/Arithmetic_Operators	/de/docs/Web/JavaScript/Reference/Operators
/de/docs/Web/JavaScript/Reference/Operators/Bitwise_Operatoren	/de/docs/conflicting/Web/JavaScript/Reference/Operators
/de/docs/Web/JavaScript/Reference/Operators/Dekrement	/de/docs/Web/JavaScript/Reference/Operators/Decrement
/de/docs/Web/JavaScript/Reference/Operators/Destrukturierende_Zuweisung	/de/docs/Web/JavaScript/Reference/Operators/Destructuring_assignment
/de/docs/Web/JavaScript/Reference/Operators/Inkrement	/de/docs/Web/JavaScript/Reference/Operators/Increment
/de/docs/Web/JavaScript/Reference/Operators/Logische_Operatoren	/de/docs/conflicting/Web/JavaScript/Reference/Operators_8b4515dbed18a24ecb01bfe0755ca163
/de/docs/Web/JavaScript/Reference/Operators/Modulo	/de/docs/Web/JavaScript/Reference/Operators/Remainder
/de/docs/Web/JavaScript/Reference/Operators/Objekt_Initialisierer	/de/docs/Web/JavaScript/Reference/Operators/Object_initializer
/de/docs/Web/JavaScript/Reference/Operators/Optionale_Verkettung	/de/docs/Web/JavaScript/Reference/Operators/Optional_chaining
/de/docs/Web/JavaScript/Reference/Operators/Spread_operator	/de/docs/conflicting/Web/JavaScript/Reference/Operators/Spread_syntax
/de/docs/Web/JavaScript/Reference/Operators/Vergleichsoperatoren	/de/docs/conflicting/Web/JavaScript/Reference/Operators_5b3986b830cf68059c03079ef10ff039
/de/docs/Web/JavaScript/Reference/Operators/Zuweisungsoperator	/de/docs/conflicting/Web/JavaScript/Reference/Operators_bf514126b51a6e9b7591809ecc554076
/de/docs/Web/JavaScript/Reference/Properties_Index	/de/docs/Web/JavaScript/Reference
/de/docs/Web/JavaScript/Reference/Statements/default	/de/docs/conflicting/Web/JavaScript/Reference/Statements/switch
/de/docs/Web/JavaScript/Reference/Statements/funktion	/de/docs/Web/JavaScript/Reference/Statements/function
/de/docs/Web/JavaScript/Reference/Veraltete_und_abgeschaffte_Features	/de/docs/Web/JavaScript/Reference/Deprecated_and_obsolete_features
/de/docs/Web/JavaScript/Reference/Veraltete_und_abgeschaffte_Features/The_legacy_Iterator_protocol	/de/docs/Web/JavaScript/Reference/Deprecated_and_obsolete_features/The_legacy_Iterator_protocol
/de/docs/Web/JavaScript/Reference/template_strings	/de/docs/Web/JavaScript/Reference/Template_literals
/de/docs/Web/JavaScript/Speicherverwaltung	/de/docs/Web/JavaScript/Memory_Management
/de/docs/Web/JavaScript/Tutorials	/de/docs/Web/JavaScript
/de/docs/Web/JavaScript/Vergleiche_auf_Gleichheit_und_deren_Verwendung	/de/docs/Web/JavaScript/Equality_comparisons_and_sameness
/de/docs/Web/JavaScript/java_guide	/de/docs/Web/JavaScript/Guide
/de/docs/Web/JavaScript/javascript_guide	/de/docs/Web/JavaScript/Guide
/de/docs/Web/JavaScript/javascript_guide/Ausdr√ºcke_und_Operatoren	/de/docs/Web/JavaScript/Guide/Expressions_and_Operators
/de/docs/Web/JavaScript/javascript_guide/Javascript_√úbersicht	/de/docs/Web/JavaScript/Guide/Introduction
/de/docs/Web/JavaScript/javascript_guide/Werte,_Variable_und_Literale	/de/docs/Web/JavaScript/Guide/Grammar_and_types
/de/docs/Web/JavaScript/javascript_guide/Werte,_Variablen_und_Literale	/de/docs/Web/JavaScript/Guide/Grammar_and_types
/de/docs/Web/JavaScript/javascript_guide/ueber_javascript	/de/docs/Web/JavaScript/Guide/Introduction
/de/docs/Web/JavaScript/javascript_guide/ueber_javascript/√úber_Javascript	/de/docs/Web/JavaScript/Guide/Introduction
/de/docs/Web/JavaScript/javascript_guide/√úber_Javascript	/de/docs/Web/JavaScript/Guide/Introduction
/de/docs/Web/JavaScript/javascript_guide/√úber_diese_Einf√ºhrung	/de/docs/Web/JavaScript/Guide/Introduction
/de/docs/Web/JavaScript/ueber_JavaScript	/de/docs/Web/JavaScript/Guide/Introduction
/de/docs/Web/JavaScript/ueber_JavaScript/√úber_Javascript	/de/docs/Web/JavaScript/Guide/Introduction
/de/docs/Web/JavaScript/√úber_Javascript	/de/docs/Web/JavaScript/Guide/Introduction
/de/docs/Web/MathML/Attribute/Werte	/de/docs/Web/MathML/Attribute/Values
/de/docs/Web/MathML/Beispiele	/de/docs/Web/MathML/Examples
/de/docs/Web/MathML/Beispiele/MathML_Satz_des_Pythagoras	/de/docs/Web/MathML/Examples/MathML_Pythagorean_Theorem
/de/docs/Web/MathML/Beispiele/Quadratische_Gleichung	/de/docs/Web/MathML/Examples/Deriving_the_Quadratic_Formula
/de/docs/Web/SVG/Tutorial/Einf√ºhrung	/de/docs/Web/SVG/Tutorial/Introduction
/de/docs/Web/SVG/Tutorial/Pfade	/de/docs/Web/SVG/Tutorial/Paths
/de/docs/Web/SVG/Tutorial/SVG_Schriftarten	/de/docs/Web/SVG/Tutorial/SVG_fonts
/de/docs/Web/Security/Public_Key_Pinning	/de/docs/Web/HTTP/Public_Key_Pinning
/de/docs/Web/WebAPI	/de/docs/conflicting/Web/API
/de/docs/Web/WebAPI/verwenden_von_geolocation	/de/docs/Web/API/Geolocation_API
/de/docs/Web/WebGL	/de/docs/Web/API/WebGL_API
/de/docs/Web/WebGL/3D-Objekte_mit_WebGL_erstellen	/de/docs/Web/API/WebGL_API/Tutorial/Creating_3D_objects_using_WebGL
/de/docs/Web/WebGL/Animierte_Texturen_in_WebGL	/de/docs/Web/API/WebGL_API/Tutorial/Animating_textures_in_WebGL
/de/docs/Web/WebGL/Beleuchtung_in_WebGL	/de/docs/Web/API/WebGL_API/Tutorial/Lighting_in_WebGL
/de/docs/Web/WebGL/Einf√ºhrung_in_WebGL	/de/docs/Web/API/WebGL_API/Tutorial/Getting_started_with_WebGL
/de/docs/Web/WebGL/Farben_mittels_Shader_in_einen_WebGL-Kontext_hinzuf√ºgen	/de/docs/Web/API/WebGL_API/Tutorial/Using_shaders_to_apply_color_in_WebGL
/de/docs/Web/WebGL/Hinzuf√ºgen_von_2D_Inhalten_in_einen_WebGL-Kontext	/de/docs/Web/API/WebGL_API/Tutorial/Adding_2D_content_to_a_WebGL_context
/de/docs/Web/WebGL/Objekte_mit_WebGL_animieren	/de/docs/Web/API/WebGL_API/Tutorial/Animating_objects_with_WebGL
/de/docs/Web/WebGL/Texturen_in_WebGL_verwenden	/de/docs/Web/API/WebGL_API/Tutorial/Using_textures_in_WebGL
/de/docs/Web/Web_Components/Custom_Elements	/de/docs/conflicting/Web/Web_Components/Using_custom_elements
/de/docs/Web/XML/XML_Einf√ºhrung	/de/docs/Web/XML/XML_introduction
/de/docs/WebGL	/de/docs/Web/API/WebGL_API
/de/docs/WebGL/3D-Objekte_mit_WebGL_erstellen	/de/docs/Web/API/WebGL_API/Tutorial/Creating_3D_objects_using_WebGL
/de/docs/WebGL/Animierte_Texturen_in_WebGL	/de/docs/Web/API/WebGL_API/Tutorial/Animating_textures_in_WebGL
/de/docs/WebGL/Beleuchtung_in_WebGL	/de/docs/Web/API/WebGL_API/Tutorial/Lighting_in_WebGL
/de/docs/WebGL/Einf√ºhrung_in_WebGL	/de/docs/Web/API/WebGL_API/Tutorial/Getting_started_with_WebGL
/de/docs/WebGL/Farben_mittels_Shader_in_einen_WebGL-Kontext_hinzuf√ºgen	/de/docs/Web/API/WebGL_API/Tutorial/Using_shaders_to_apply_color_in_WebGL
/de/docs/WebGL/Hinzuf√ºgen_von_2D_Inhalten_in_einen_WebGL-Kontext	/de/docs/Web/API/WebGL_API/Tutorial/Adding_2D_content_to_a_WebGL_context
/de/docs/WebGL/Objekte_mit_WebGL_animieren	/de/docs/Web/API/WebGL_API/Tutorial/Animating_objects_with_WebGL
/de/docs/WebGL/Texturen_in_WebGL_verwenden	/de/docs/Web/API/WebGL_API/Tutorial/Using_textures_in_WebGL
/de/docs/WebSockets	/de/docs/Web/API/WebSockets_API
/de/docs/WebSockets/Writing_WebSocket_servers	/de/docs/Web/API/WebSockets_API/Writing_WebSocket_servers
/de/docs/Web_Development/Mobile	/de/docs/Web/Guide/Mobile
/de/docs/Web_Development/Mobile/Responsive_design	/de/docs/conflicting/Web/Progressive_web_apps
/de/docs/Webbasierte_protokoll-handler	/de/docs/Web/API/Navigator/registerProtocolHandler/Web-based_protocol_handlers
/de/docs/Webentwicklung	/de/docs/conflicting/Web/Guide
/de/docs/Werkzeuge	/de/docs/Tools
/de/docs/XML_Einf√ºhrung	/de/docs/Web/XML/XML_introduction
/de/docs/XSLT	/de/docs/Web/XSLT
/de/docs/Zugriff_auf_Dateien_von_Webapplikationen	/de/docs/Web/API/File/Using_files_from_web_applications
/de/docs/en	/en-US/
/de/docs/install.rdf	/de/docs/Installationsmanifest
