# FROM-URL	TO-URL
/hu/docs/Bevezetés_a_dokumentumobjektum-modellbe	/hu/docs/Web/API/Document_Object_Model
/hu/docs/CSS	/hu/docs/Web/CSS
/hu/docs/CSS/CSS_Grid_Layout	/hu/docs/Web/CSS/CSS_Grid_Layout
/hu/docs/CSS/font-weight	/hu/docs/Web/CSS/font-weight
/hu/docs/CSS/text-decoration	/hu/docs/Web/CSS/text-decoration
/hu/docs/DOM	/hu/docs/conflicting/Web/API/Document_Object_Model
/hu/docs/DOM/HTMLBRElement	/hu/docs/Web/API/HTMLBRElement
/hu/docs/Glossary/Elso_osztalyu_funkciok	/hu/docs/Glossary/First-class_Function
/hu/docs/Glossary/bongeszo	/hu/docs/Glossary/Browser
/hu/docs/HTML	/hu/docs/Web/HTML
/hu/docs/HTML/Element	/hu/docs/Web/HTML/Element
/hu/docs/HTML/Element/br	/hu/docs/Web/HTML/Element/br
/hu/docs/JavaScript	/hu/docs/Web/JavaScript
/hu/docs/JavaScript_1.5_kézikönyv	/hu/docs/Web/JavaScript/Guide
/hu/docs/Kezdőlap	/hu/docs/Web
/hu/docs/Learn/HTML/Bevezetes_a_HTML-be	/hu/docs/Learn/HTML/Introduction_to_HTML
/hu/docs/Learn/Ismerkedés_a_Világhálóval	/hu/docs/Learn/Getting_started_with_the_web
/hu/docs/Learn/Ismerkedés_a_Világhálóval/Alapvető_programok_telepítése	/hu/docs/Learn/Getting_started_with_the_web/Installing_basic_software
/hu/docs/Learn/Ismerkedés_a_Világhálóval/Hogy_fog_kinézni_a_weboldalunk	/hu/docs/Learn/Getting_started_with_the_web/What_will_your_website_look_like
/hu/docs/Learn/JavaScript/Első_lépések	/hu/docs/Learn/JavaScript/First_steps
/hu/docs/MDN/Getting_started	/hu/docs/MDN/Contribute/Getting_started
/hu/docs/Web/API/Window.stop	/hu/docs/Web/API/Window/stop
/hu/docs/Web/API/XMLHttpRequest/XMLHttpRequest_hasznalata	/hu/docs/Web/API/XMLHttpRequest/Using_XMLHttpRequest
/hu/docs/Web/CSS/Tools/Border-radius_bemutato	/hu/docs/Web/CSS/CSS_Background_and_Borders/Border-radius_generator
/hu/docs/Web/Guide/Grafika	/hu/docs/Web/Guide/Graphics
/hu/docs/Web/JavaScript/Guide/Bevezetés	/hu/docs/Web/JavaScript/Guide/Introduction
/hu/docs/Web/JavaScript/JavaScript_1.5_kézikönyv	/hu/docs/Web/JavaScript/Guide
/hu/docs/Web/JavaScript/Reference/Errors/Érvénytelen_típus	/hu/docs/Web/JavaScript/Reference/Errors/Unexpected_type
/hu/docs/Web/JavaScript/Reference/Global_Objects/Függvény	/hu/docs/Web/JavaScript/Reference/Global_Objects/Function
/hu/docs/Web/JavaScript/a_javascript_ujboli_bemutatasa	/hu/docs/Web/JavaScript/A_re-introduction_to_JavaScript
/hu/docs/WebSockets	/hu/docs/Web/API/WebSockets_API
/hu/docs/en	/en-US/
