# FROM-URL	TO-URL
/pt-BR/docs/AJAX	/pt-BR/docs/Web/Guide/AJAX
/pt-BR/docs/AJAX/Getting_Started	/pt-BR/docs/Web/Guide/AJAX/Getting_Started
/pt-BR/docs/API_Web_Audio	/pt-BR/docs/Web/API/Web_Audio_API
/pt-BR/docs/Aprender	/pt-BR/docs/Learn
/pt-BR/docs/Aprender/CSS	/pt-BR/docs/Learn/CSS
/pt-BR/docs/Aprender/CSS/Construindo_blocos	/pt-BR/docs/Learn/CSS/Building_blocks
/pt-BR/docs/Aprender/CSS/Construindo_blocos/Cascade_and_inheritance	/pt-BR/docs/Learn/CSS/Building_blocks/Cascade_and_inheritance
/pt-BR/docs/Aprender/CSS/Construindo_blocos/The_box_model	/pt-BR/docs/Learn/CSS/Building_blocks/The_box_model
/pt-BR/docs/Aprender/CSS/Estilizando_texto	/pt-BR/docs/Learn/CSS/Styling_text
/pt-BR/docs/Aprender/CSS/Introduction_to_CSS	/en-US/docs/Learn/CSS/First_steps
/pt-BR/docs/Aprender/CSS/Introduction_to_CSS/Cascade_and_inheritance	/en-US/docs/Learn/CSS/Building_blocks/Cascade_and_inheritance
/pt-BR/docs/Aprender/CSS/Introduction_to_CSS/Combinators_and_multiple_selectors	/en-US/docs/Learn/CSS/Building_blocks/Selectors/Combinators
/pt-BR/docs/Aprender/CSS/Introduction_to_CSS/Seletores	/en-US/docs/Learn/CSS/Building_blocks/Selectors
/pt-BR/docs/Aprender/CSS/Introduction_to_CSS/Valores_e_unidades	/en-US/docs/Learn/CSS/Building_blocks/Values_and_units
/pt-BR/docs/Aprender/CSS/Introduction_to_CSS/como_CSS_funciona	/en-US/docs/Learn/CSS/First_steps/How_CSS_works
/pt-BR/docs/Aprender/CSS/Introduction_to_CSS/sintaxe	/en-US/docs/Learn/CSS/First_steps/How_CSS_is_structured
/pt-BR/docs/Aprender/CSS/Styling_boxes	/en-US/docs/Learn/CSS/Building_blocks
/pt-BR/docs/Aprender/Como_contribuir	/pt-BR/docs/orphaned/Learn/How_to_contribute
/pt-BR/docs/Aprender/Design_e_acessibilidade	/pt-BR/docs/Learn/Common_questions
/pt-BR/docs/Aprender/Ferramentas_e_teste	/pt-BR/docs/Learn/Tools_and_testing
/pt-BR/docs/Aprender/Front-end_web_developer	/pt-BR/docs/Learn/Front-end_web_developer
/pt-BR/docs/Aprender/Getting_started_with_the_web	/pt-BR/docs/Learn/Getting_started_with_the_web
/pt-BR/docs/Aprender/Getting_started_with_the_web/A_web_e_seus_padrões	/pt-BR/docs/Learn/Getting_started_with_the_web/The_web_and_web_standards
/pt-BR/docs/Aprender/Getting_started_with_the_web/CSS_basico	/pt-BR/docs/Learn/Getting_started_with_the_web/CSS_basics
/pt-BR/docs/Aprender/Getting_started_with_the_web/Como_a_Web_funciona	/pt-BR/docs/Learn/Getting_started_with_the_web/How_the_Web_works
/pt-BR/docs/Aprender/Getting_started_with_the_web/HTML_basico	/pt-BR/docs/Learn/Getting_started_with_the_web/HTML_basics
/pt-BR/docs/Aprender/Getting_started_with_the_web/JavaScript_basico	/pt-BR/docs/Learn/Getting_started_with_the_web/JavaScript_basics
/pt-BR/docs/Aprender/Getting_started_with_the_web/Publicando_seu_site	/pt-BR/docs/Learn/Getting_started_with_the_web/Publishing_your_website
/pt-BR/docs/Aprender/Getting_started_with_the_web/com_que_seu_site_vai_parecer	/pt-BR/docs/Learn/Getting_started_with_the_web/What_will_your_website_look_like
/pt-BR/docs/Aprender/Getting_started_with_the_web/instalando_programas_basicos	/pt-BR/docs/Learn/Getting_started_with_the_web/Installing_basic_software
/pt-BR/docs/Aprender/Getting_started_with_the_web/lidando_com_arquivos	/pt-BR/docs/Learn/Getting_started_with_the_web/Dealing_with_files
/pt-BR/docs/Aprender/HTML	/pt-BR/docs/Learn/HTML
/pt-BR/docs/Aprender/HTML/Introducao_ao_HTML	/pt-BR/docs/Learn/HTML/Introduction_to_HTML
/pt-BR/docs/Aprender/HTML/Introducao_ao_HTML/Criando_hyperlinks	/pt-BR/docs/Learn/HTML/Introduction_to_HTML/Creating_hyperlinks
/pt-BR/docs/Aprender/HTML/Introducao_ao_HTML/Debugging_HTML	/pt-BR/docs/Learn/HTML/Introduction_to_HTML/Debugging_HTML
/pt-BR/docs/Aprender/HTML/Introducao_ao_HTML/Estrutura_de_documento_e_sites	/pt-BR/docs/Learn/HTML/Introduction_to_HTML/Document_and_website_structure
/pt-BR/docs/Aprender/HTML/Introducao_ao_HTML/Formatacao_avancada_texto	/pt-BR/docs/Learn/HTML/Introduction_to_HTML/Advanced_text_formatting
/pt-BR/docs/Aprender/HTML/Introducao_ao_HTML/Fundamentos_textuais_HTML	/pt-BR/docs/Learn/HTML/Introduction_to_HTML/HTML_text_fundamentals
/pt-BR/docs/Aprender/HTML/Introducao_ao_HTML/Getting_started	/pt-BR/docs/Learn/HTML/Introduction_to_HTML/Getting_started
/pt-BR/docs/Aprender/HTML/Introducao_ao_HTML/Test_your_skills:_HTML_text_basics	/pt-BR/docs/Learn/HTML/Introduction_to_HTML/Test_your_skills:_HTML_text_basics
/pt-BR/docs/Aprender/HTML/Introducao_ao_HTML/The_head_metadata_in_HTML	/pt-BR/docs/Learn/HTML/Introduction_to_HTML/The_head_metadata_in_HTML
/pt-BR/docs/Aprender/HTML/Multimedia_and_embedding	/pt-BR/docs/Learn/HTML/Multimedia_and_embedding
/pt-BR/docs/Aprender/HTML/Multimedia_and_embedding/Adding_vector_graphics_to_the_Web	/pt-BR/docs/Learn/HTML/Multimedia_and_embedding/Adding_vector_graphics_to_the_Web
/pt-BR/docs/Aprender/HTML/Multimedia_and_embedding/Images_in_HTML	/pt-BR/docs/Learn/HTML/Multimedia_and_embedding/Images_in_HTML
/pt-BR/docs/Aprender/HTML/Multimedia_and_embedding/Other_embedding_technologies	/pt-BR/docs/Learn/HTML/Multimedia_and_embedding/Other_embedding_technologies
/pt-BR/docs/Aprender/HTML/Multimedia_and_embedding/Responsive_images	/pt-BR/docs/Learn/HTML/Multimedia_and_embedding/Responsive_images
/pt-BR/docs/Aprender/HTML/Multimedia_and_embedding/Video_and_audio_content	/pt-BR/docs/Learn/HTML/Multimedia_and_embedding/Video_and_audio_content
/pt-BR/docs/Aprender/HTML/Tables	/pt-BR/docs/Learn/HTML/Tables
/pt-BR/docs/Aprender/HTML/Tables/Basics	/pt-BR/docs/Learn/HTML/Tables/Basics
/pt-BR/docs/Aprender/HTML/como-fazer	/pt-BR/docs/Learn/HTML/Howto
/pt-BR/docs/Aprender/JavaScript	/pt-BR/docs/Learn/JavaScript
/pt-BR/docs/Aprender/JavaScript/Client-side_web_APIs	/pt-BR/docs/Learn/JavaScript/Client-side_web_APIs
/pt-BR/docs/Aprender/JavaScript/Client-side_web_APIs/Client-side_storage	/pt-BR/docs/Learn/JavaScript/Client-side_web_APIs/Client-side_storage
/pt-BR/docs/Aprender/JavaScript/Client-side_web_APIs/Introdução	/pt-BR/docs/Learn/JavaScript/Client-side_web_APIs/Introduction
/pt-BR/docs/Aprender/JavaScript/Elementos_construtivos	/pt-BR/docs/Learn/JavaScript/Building_blocks
/pt-BR/docs/Aprender/JavaScript/Elementos_construtivos/Build_your_own_function	/pt-BR/docs/Learn/JavaScript/Building_blocks/Build_your_own_function
/pt-BR/docs/Aprender/JavaScript/Elementos_construtivos/Código_em_loop	/pt-BR/docs/Learn/JavaScript/Building_blocks/Looping_code
/pt-BR/docs/Aprender/JavaScript/Elementos_construtivos/Events	/pt-BR/docs/Learn/JavaScript/Building_blocks/Events
/pt-BR/docs/Aprender/JavaScript/Elementos_construtivos/Functions	/pt-BR/docs/Learn/JavaScript/Building_blocks/Functions
/pt-BR/docs/Aprender/JavaScript/Elementos_construtivos/Image_gallery	/pt-BR/docs/Learn/JavaScript/Building_blocks/Image_gallery
/pt-BR/docs/Aprender/JavaScript/Elementos_construtivos/Return_values	/pt-BR/docs/Learn/JavaScript/Building_blocks/Return_values
/pt-BR/docs/Aprender/JavaScript/Elementos_construtivos/conditionals	/pt-BR/docs/Learn/JavaScript/Building_blocks/conditionals
/pt-BR/docs/Aprender/JavaScript/Howto	/pt-BR/docs/Learn/JavaScript/Howto
/pt-BR/docs/Aprender/JavaScript/Objetos	/pt-BR/docs/Learn/JavaScript/Objects
/pt-BR/docs/Aprender/JavaScript/Objetos/Adding_bouncing_balls_features	/pt-BR/docs/Learn/JavaScript/Objects/Adding_bouncing_balls_features
/pt-BR/docs/Aprender/JavaScript/Objetos/Básico	/pt-BR/docs/Learn/JavaScript/Objects/Basics
/pt-BR/docs/Aprender/JavaScript/Objetos/Herança	/pt-BR/docs/Learn/JavaScript/Objects/Inheritance
/pt-BR/docs/Aprender/JavaScript/Objetos/JSON	/pt-BR/docs/Learn/JavaScript/Objects/JSON
/pt-BR/docs/Aprender/JavaScript/Objetos/Object-oriented_JS	/pt-BR/docs/Learn/JavaScript/Objects/Object-oriented_JS
/pt-BR/docs/Aprender/JavaScript/Objetos/Object_building_practice	/pt-BR/docs/Learn/JavaScript/Objects/Object_building_practice
/pt-BR/docs/Aprender/JavaScript/Objetos/Object_prototypes	/pt-BR/docs/Learn/JavaScript/Objects/Object_prototypes
/pt-BR/docs/Aprender/Learning_and_getting_help	/pt-BR/docs/Learn/Learning_and_getting_help
/pt-BR/docs/Aprender/Release_notes	/pt-BR/docs/Learn/Release_notes
/pt-BR/docs/CSS	/pt-BR/docs/Web/CSS
/pt-BR/docs/CSS/@page	/pt-BR/docs/Web/CSS/@page
/pt-BR/docs/CSS/At-rule	/pt-BR/docs/Web/CSS/At-rule
/pt-BR/docs/CSS/CSS_Reference	/pt-BR/docs/Web/CSS/Reference
/pt-BR/docs/CSS/Especificação	/pt-BR/docs/Web/CSS/Specificity
/pt-BR/docs/CSS/Getting_Started	/pt-BR/docs/conflicting/Learn/CSS/First_steps
/pt-BR/docs/CSS/Getting_Started/JavaScript	/pt-BR/docs/Learn/JavaScript/Client-side_web_APIs/Manipulating_documents
/pt-BR/docs/CSS/Multiple_backgrounds	/pt-BR/docs/Web/CSS/CSS_Backgrounds_and_Borders/Using_multiple_backgrounds
/pt-BR/docs/CSS/Primeiros_Passos	/pt-BR/docs/conflicting/Learn/CSS/First_steps
/pt-BR/docs/CSS/Specificity	/pt-BR/docs/Web/CSS/Specificity
/pt-BR/docs/CSS/Usando_animacoes_CSS	/pt-BR/docs/Web/CSS/CSS_Animations/Using_CSS_animations
/pt-BR/docs/CSS/Usando_caixas_flexiveis_css	/pt-BR/docs/conflicting/Web/CSS/CSS_Flexible_Box_Layout/Basic_Concepts_of_Flexbox
/pt-BR/docs/CSS/Using_CSS_animations	/pt-BR/docs/Web/CSS/CSS_Animations/Using_CSS_animations
/pt-BR/docs/CSS/Using_CSS_transforms	/pt-BR/docs/Web/CSS/CSS_Transforms/Using_CSS_transforms
/pt-BR/docs/CSS/display	/pt-BR/docs/Web/CSS/display
/pt-BR/docs/CSS/overflow	/pt-BR/docs/Web/CSS/overflow
/pt-BR/docs/CSS/regra at	/pt-BR/docs/Web/CSS/At-rule
/pt-BR/docs/CSS/repeating-linear-gradient	/pt-BR/docs/Web/CSS/repeating-linear-gradient()
/pt-BR/docs/CSS/sintaxe	/pt-BR/docs/Web/CSS/Syntax
/pt-BR/docs/CSS/text-overflow	/pt-BR/docs/Web/CSS/text-overflow
/pt-BR/docs/CSS/text-rendering	/pt-BR/docs/Web/CSS/text-rendering
/pt-BR/docs/CSS/transform	/pt-BR/docs/Web/CSS/transform
/pt-BR/docs/CSS/word-wrap	/pt-BR/docs/Web/CSS/overflow-wrap
/pt-BR/docs/Construindo_um_complemento	/pt-BR/docs/conflicting/Mozilla/Add-ons
/pt-BR/docs/DOM	/pt-BR/docs/conflicting/Web/API/Document_Object_Model
/pt-BR/docs/DOM/BatteryManager.charging	/pt-BR/docs/Web/API/BatteryManager/charging
/pt-BR/docs/DOM/Document.querySelector	/pt-BR/docs/Web/API/Document/querySelector
/pt-BR/docs/DOM/Document.querySelectorAll	/pt-BR/docs/Web/API/Document/querySelectorAll
/pt-BR/docs/DOM/Referencia_do_DOM	/pt-BR/docs/Web/API/Document_Object_Model
/pt-BR/docs/DOM/Referencia_do_DOM/Events	/pt-BR/docs/Web/API/Document_Object_Model/Events
/pt-BR/docs/DOM/Referencia_do_DOM/Examples	/pt-BR/docs/Web/API/Document_Object_Model/Examples
/pt-BR/docs/DOM/Referencia_do_DOM/How_to_create_a_DOM_tree	/pt-BR/docs/Web/API/Document_object_model/How_to_create_a_DOM_tree
/pt-BR/docs/DOM/Referencia_do_DOM/Introdução	/pt-BR/docs/Web/API/Document_Object_Model/Introduction
/pt-BR/docs/DOM/Referencia_do_DOM/Whitespace_in_the_DOM	/pt-BR/docs/Web/API/Document_Object_Model/Whitespace
/pt-BR/docs/DOM/XMLHttpRequest	/pt-BR/docs/Web/API/XMLHttpRequest
/pt-BR/docs/DOM/XMLHttpRequest/Usando_XMLHttpRequest	/pt-BR/docs/Web/API/XMLHttpRequest/Using_XMLHttpRequest
/pt-BR/docs/DOM/element.addEventListener	/pt-BR/docs/Web/API/EventTarget/addEventListener
/pt-BR/docs/DOM/element.addEventListener-redirect-1	/pt-BR/docs/Web/API/EventTarget/addEventListener
/pt-BR/docs/DOM/window.URL.createObjectURL	/pt-BR/docs/Web/API/URL/createObjectURl
/pt-BR/docs/DOM/window.onscroll	/pt-BR/docs/conflicting/Web/API/GlobalEventHandlers/onscroll
/pt-BR/docs/Developer_Guide	/pt-BR/docs/Mozilla/Developer_guide
/pt-BR/docs/Developer_Guide/Codigo_Fonte	/pt-BR/docs/Mozilla/Developer_guide/Source_Code
/pt-BR/docs/Developer_Guide/Mozilla_build_FAQ	/pt-BR/docs/Mozilla/Developer_guide/Mozilla_build_FAQ
/pt-BR/docs/DragDrop	/pt-BR/docs/conflicting/Web/API/HTML_Drag_and_Drop_API
/pt-BR/docs/DragDrop/Arrastar_e_Soltar	/pt-BR/docs/Web/API/HTML_Drag_and_Drop_API
/pt-BR/docs/DragDrop/Drag_and_Drop	/pt-BR/docs/Web/API/HTML_Drag_and_Drop_API
/pt-BR/docs/DragDrop/Drag_and_Drop/Arrastar_e_soltar_arquivos	/pt-BR/docs/Web/API/HTML_Drag_and_Drop_API/File_drag_and_drop
/pt-BR/docs/Eventos_on-line_off-line	/pt-BR/docs/Web/API/NavigatorOnLine/Online_and_offline_events
/pt-BR/docs/Games/Introduction_to_HTML5_Game_Gevelopment_(summary)	/pt-BR/docs/Games/Introduction_to_HTML5_Game_Development
/pt-BR/docs/Glossario	/pt-BR/docs/Glossary
/pt-BR/docs/Glossario/404	/pt-BR/docs/Glossary/404
/pt-BR/docs/Glossario/502	/pt-BR/docs/Glossary/502
/pt-BR/docs/Glossario/AJAX	/pt-BR/docs/Glossary/AJAX
/pt-BR/docs/Glossario/API	/pt-BR/docs/Glossary/API
/pt-BR/docs/Glossario/ASCII	/pt-BR/docs/Glossary/ASCII
/pt-BR/docs/Glossario/Abstração	/pt-BR/docs/Glossary/Abstraction
/pt-BR/docs/Glossario/Acessibilidade	/pt-BR/docs/Glossary/Accessibility
/pt-BR/docs/Glossario/Adobe_Flash	/pt-BR/docs/Glossary/Adobe_Flash
/pt-BR/docs/Glossario/Algoritmo	/pt-BR/docs/Glossary/Algorithm
/pt-BR/docs/Glossario/Alpha	/pt-BR/docs/Glossary/Alpha
/pt-BR/docs/Glossario/Apple_Safari	/pt-BR/docs/Glossary/Apple_Safari
/pt-BR/docs/Glossario/Argument	/pt-BR/docs/Glossary/Argument
/pt-BR/docs/Glossario/Arpanet	/pt-BR/docs/Glossary/Arpanet
/pt-BR/docs/Glossario/Assincrono	/pt-BR/docs/Glossary/Asynchronous
/pt-BR/docs/Glossario/Atributo	/pt-BR/docs/Glossary/Attribute
/pt-BR/docs/Glossario/Bandwidth	/pt-BR/docs/Glossary/Bandwidth
/pt-BR/docs/Glossario/BigInt	/pt-BR/docs/Glossary/BigInt
/pt-BR/docs/Glossario/Booleano	/pt-BR/docs/Glossary/Boolean
/pt-BR/docs/Glossario/CDN	/pt-BR/docs/Glossary/CDN
/pt-BR/docs/Glossario/CMS	/pt-BR/docs/Glossary/CMS
/pt-BR/docs/Glossario/CORS	/pt-BR/docs/Glossary/CORS
/pt-BR/docs/Glossario/CRUD	/pt-BR/docs/Glossary/CRUD
/pt-BR/docs/Glossario/CSS	/pt-BR/docs/Glossary/CSS
/pt-BR/docs/Glossario/CSSOM	/pt-BR/docs/Glossary/CSSOM
/pt-BR/docs/Glossario/CSS_Selector	/pt-BR/docs/Glossary/CSS_Selector
/pt-BR/docs/Glossario/CSS_pixel	/pt-BR/docs/Glossary/CSS_pixel
/pt-BR/docs/Glossario/CSS_preprocessor	/pt-BR/docs/Glossary/CSS_preprocessor
/pt-BR/docs/Glossario/Cabecalho_HTTP	/pt-BR/docs/Glossary/HTTP_header
/pt-BR/docs/Glossario/Cache	/pt-BR/docs/Glossary/Cache
/pt-BR/docs/Glossario/Call_stack	/pt-BR/docs/Glossary/Call_stack
/pt-BR/docs/Glossario/Callback_function	/pt-BR/docs/Glossary/Callback_function
/pt-BR/docs/Glossario/Caractere	/pt-BR/docs/Glossary/Character
/pt-BR/docs/Glossario/Chrome	/pt-BR/docs/Glossary/Chrome
/pt-BR/docs/Glossario/Class	/pt-BR/docs/Glossary/Class
/pt-BR/docs/Glossario/Conversao_de_Tipo	/pt-BR/docs/Glossary/Type_Conversion
/pt-BR/docs/Glossario/DOM	/pt-BR/docs/Glossary/DOM
/pt-BR/docs/Glossario/Declaração	/pt-BR/docs/Glossary/Statement
/pt-BR/docs/Glossario/Doctype	/pt-BR/docs/Glossary/Doctype
/pt-BR/docs/Glossario/Domínio	/pt-BR/docs/Glossary/Domain
/pt-BR/docs/Glossario/ECMA	/pt-BR/docs/Glossary/ECMA
/pt-BR/docs/Glossario/Elemento	/pt-BR/docs/Glossary/Element
/pt-BR/docs/Glossario/Endereco_IP	/pt-BR/docs/Glossary/IP_Address
/pt-BR/docs/Glossario/Endianness	/pt-BR/docs/Glossary/Endianness
/pt-BR/docs/Glossario/Entity_header	/pt-BR/docs/Glossary/Entity_header
/pt-BR/docs/Glossario/Escopo	/pt-BR/docs/Glossary/Scope
/pt-BR/docs/Glossario/Falsy	/pt-BR/docs/Glossary/Falsy
/pt-BR/docs/Glossario/Flex	/pt-BR/docs/Glossary/Flex
/pt-BR/docs/Glossario/Forbidden_header_name	/pt-BR/docs/Glossary/Forbidden_header_name
/pt-BR/docs/Glossario/Forbidden_response_header_name	/pt-BR/docs/Glossary/Forbidden_response_header_name
/pt-BR/docs/Glossario/Funcao-First-class	/pt-BR/docs/Glossary/First-class_Function
/pt-BR/docs/Glossario/Função	/pt-BR/docs/Glossary/Function
/pt-BR/docs/Glossario/Fuzzing	/pt-BR/docs/Glossary/Fuzzing
/pt-BR/docs/Glossario/Gecko	/pt-BR/docs/Glossary/Gecko
/pt-BR/docs/Glossario/General_header	/pt-BR/docs/Glossary/General_header
/pt-BR/docs/Glossario/Global_object	/pt-BR/docs/Glossary/Global_object
/pt-BR/docs/Glossario/Grade	/pt-BR/docs/Glossary/Grid
/pt-BR/docs/Glossario/Grid_Areas	/pt-BR/docs/Glossary/Grid_Areas
/pt-BR/docs/Glossario/HSTS	/pt-BR/docs/Glossary/HSTS
/pt-BR/docs/Glossario/HTML	/pt-BR/docs/Glossary/HTML
/pt-BR/docs/Glossario/HTTP	/pt-BR/docs/Glossary/HTTP
/pt-BR/docs/Glossario/HTTP_2	/pt-BR/docs/Glossary/HTTP_2
/pt-BR/docs/Glossario/Hoisting	/pt-BR/docs/Glossary/Hoisting
/pt-BR/docs/Glossario/IIFE	/pt-BR/docs/Glossary/IIFE
/pt-BR/docs/Glossario/IPv4	/pt-BR/docs/Glossary/IPv4
/pt-BR/docs/Glossario/IPv6	/pt-BR/docs/Glossary/IPv6
/pt-BR/docs/Glossario/IRC	/pt-BR/docs/Glossary/IRC
/pt-BR/docs/Glossario/ISO	/pt-BR/docs/Glossary/ISO
/pt-BR/docs/Glossario/Idempotente	/pt-BR/docs/Glossary/Idempotent
/pt-BR/docs/Glossario/Identificador	/pt-BR/docs/Glossary/Identifier
/pt-BR/docs/Glossario/IndexedDB	/pt-BR/docs/Glossary/IndexedDB
/pt-BR/docs/Glossario/Internet	/pt-BR/docs/Glossary/Internet
/pt-BR/docs/Glossario/JPEG	/pt-BR/docs/Glossary/jpeg
/pt-BR/docs/Glossario/Jank	/pt-BR/docs/Glossary/Jank
/pt-BR/docs/Glossario/JavaScript	/pt-BR/docs/Glossary/JavaScript
/pt-BR/docs/Glossario/Key	/pt-BR/docs/Glossary/Key
/pt-BR/docs/Glossario/Linguagem_de_programação_dinâmica	/pt-BR/docs/Glossary/Dynamic_programming_language
/pt-BR/docs/Glossario/Metadata	/pt-BR/docs/Glossary/Metadata
/pt-BR/docs/Glossario/Mozilla_Firefox	/pt-BR/docs/Glossary/Mozilla_Firefox
/pt-BR/docs/Glossario/Mutavel	/pt-BR/docs/Glossary/Mutable
/pt-BR/docs/Glossario/Navegador	/pt-BR/docs/Glossary/Browser
/pt-BR/docs/Glossario/Navegador_Opera	/pt-BR/docs/Glossary/Opera_Browser
/pt-BR/docs/Glossario/Node.js	/pt-BR/docs/Glossary/Node.js
/pt-BR/docs/Glossario/Nome_de_domínio	/pt-BR/docs/Glossary/Domain_name
/pt-BR/docs/Glossario/Nulo	/pt-BR/docs/Glossary/Null
/pt-BR/docs/Glossario/Número	/pt-BR/docs/Glossary/Number
/pt-BR/docs/Glossario/OOP	/pt-BR/docs/Glossary/OOP
/pt-BR/docs/Glossario/OTA	/pt-BR/docs/Glossary/OTA
/pt-BR/docs/Glossario/Objeto	/pt-BR/docs/Glossary/Object
/pt-BR/docs/Glossario/OpenGL	/pt-BR/docs/Glossary/OpenGL
/pt-BR/docs/Glossario/Operador	/pt-BR/docs/Glossary/Operator
/pt-BR/docs/Glossario/Operando	/pt-BR/docs/Glossary/Operand
/pt-BR/docs/Glossario/Origem	/pt-BR/docs/Glossary/Origin
/pt-BR/docs/Glossario/PHP	/pt-BR/docs/Glossary/PHP
/pt-BR/docs/Glossario/Palavra-chave	/pt-BR/docs/Glossary/Keyword
/pt-BR/docs/Glossario/Pixel	/pt-BR/docs/Glossary/Pixel
/pt-BR/docs/Glossario/Polyfill	/pt-BR/docs/Glossary/Polyfill
/pt-BR/docs/Glossario/Port	/pt-BR/docs/Glossary/Port
/pt-BR/docs/Glossario/Prefixos_vendor	/pt-BR/docs/Glossary/Vendor_Prefix
/pt-BR/docs/Glossario/Preflight_request	/pt-BR/docs/Glossary/Preflight_request
/pt-BR/docs/Glossario/Primitivo	/pt-BR/docs/Glossary/Primitive
/pt-BR/docs/Glossario/Programação_de_Computadores	/pt-BR/docs/Glossary/Computer_Programming
/pt-BR/docs/Glossario/Progressive_web_apps	/pt-BR/docs/Glossary/Progressive_web_apps
/pt-BR/docs/Glossario/Protocolo	/pt-BR/docs/Glossary/Protocol
/pt-BR/docs/Glossario/Prototype	/pt-BR/docs/Glossary/Prototype
/pt-BR/docs/Glossario/Proxy_server	/pt-BR/docs/Glossary/Proxy_server
/pt-BR/docs/Glossario/Pseudo-class	/pt-BR/docs/Glossary/Pseudo-class
/pt-BR/docs/Glossario/Pseudo-element	/pt-BR/docs/Glossary/Pseudo-element
/pt-BR/docs/Glossario/Python	/pt-BR/docs/Glossary/Python
/pt-BR/docs/Glossario/REST	/pt-BR/docs/Glossary/REST
/pt-BR/docs/Glossario/Recursão	/pt-BR/docs/Glossary/Recursion
/pt-BR/docs/Glossario/Reflow	/pt-BR/docs/Glossary/Reflow
/pt-BR/docs/Glossario/Request_header	/pt-BR/docs/Glossary/Request_header
/pt-BR/docs/Glossario/Responsive_web_design	/pt-BR/docs/Glossary/Responsive_web_design
/pt-BR/docs/Glossario/Ruby	/pt-BR/docs/Glossary/Ruby
/pt-BR/docs/Glossario/SDP	/pt-BR/docs/Glossary/SDP
/pt-BR/docs/Glossario/SEO	/pt-BR/docs/Glossary/SEO
/pt-BR/docs/Glossario/SGML	/pt-BR/docs/Glossary/SGML
/pt-BR/docs/Glossario/SVG	/pt-BR/docs/Glossary/SVG
/pt-BR/docs/Glossario/Self-Executing_Anonymous_Function	/pt-BR/docs/Glossary/Self-Executing_Anonymous_Function
/pt-BR/docs/Glossario/Semantica	/pt-BR/docs/Glossary/Semantics
/pt-BR/docs/Glossario/Servidor	/pt-BR/docs/Glossary/Server
/pt-BR/docs/Glossario/Sincrono	/pt-BR/docs/Glossary/Synchronous
/pt-BR/docs/Glossario/Sloppy_mode	/pt-BR/docs/Glossary/Sloppy_mode
/pt-BR/docs/Glossario/Stacking_context	/pt-BR/docs/Glossary/Stacking_context
/pt-BR/docs/Glossario/String	/pt-BR/docs/Glossary/String
/pt-BR/docs/Glossario/Symbol	/pt-BR/docs/Glossary/Symbol
/pt-BR/docs/Glossario/TCP	/pt-BR/docs/Glossary/TCP
/pt-BR/docs/Glossario/TLS	/pt-BR/docs/Glossary/TLS
/pt-BR/docs/Glossario/Tag	/pt-BR/docs/Glossary/Tag
/pt-BR/docs/Glossario/Three_js	/pt-BR/docs/Glossary/Three_js
/pt-BR/docs/Glossario/Tratando_Formulários_com_PHP	/pt-BR/docs/orphaned/Glossary/Tratando_Formulários_com_PHP
/pt-BR/docs/Glossario/Truthy	/pt-BR/docs/Glossary/Truthy
/pt-BR/docs/Glossario/URI	/pt-BR/docs/Glossary/URI
/pt-BR/docs/Glossario/URL	/pt-BR/docs/Glossary/URL
/pt-BR/docs/Glossario/UTF-8	/pt-BR/docs/Glossary/UTF-8
/pt-BR/docs/Glossario/UX	/pt-BR/docs/Glossary/UX
/pt-BR/docs/Glossario/Valor	/pt-BR/docs/Glossary/Value
/pt-BR/docs/Glossario/Variável	/pt-BR/docs/Glossary/Variable
/pt-BR/docs/Glossario/Viewport	/pt-BR/docs/Glossary/Viewport
/pt-BR/docs/Glossario/W3C	/pt-BR/docs/Glossary/W3C
/pt-BR/docs/Glossario/WHATWG	/pt-BR/docs/Glossary/WHATWG
/pt-BR/docs/Glossario/WebSockets	/pt-BR/docs/Glossary/WebSockets
/pt-BR/docs/Glossario/Wrapper	/pt-BR/docs/Glossary/Wrapper
/pt-BR/docs/Glossario/XHR_(XMLHttpRequest)	/pt-BR/docs/Glossary/XHR_(XMLHttpRequest)
/pt-BR/docs/Glossario/XML	/pt-BR/docs/Glossary/XML
/pt-BR/docs/Glossario/array	/pt-BR/docs/Glossary/array
/pt-BR/docs/Glossario/arvore_de_acessibilidade	/pt-BR/docs/Glossary/Accessibility_tree
/pt-BR/docs/Glossario/caret	/pt-BR/docs/Glossary/caret
/pt-BR/docs/Glossario/character_encoding	/pt-BR/docs/Glossary/character_encoding
/pt-BR/docs/Glossario/conteiner_de_alinhamento	/pt-BR/docs/Glossary/Alignment_Container
/pt-BR/docs/Glossario/degradação_graciosa	/pt-BR/docs/Glossary/Graceful_degradation
/pt-BR/docs/Glossario/https	/pt-BR/docs/Glossary/https
/pt-BR/docs/Glossario/jQuery	/pt-BR/docs/Glossary/jQuery
/pt-BR/docs/Glossario/marcação	/pt-BR/docs/Glossary/markup
/pt-BR/docs/Glossario/property	/pt-BR/docs/Glossary/property
/pt-BR/docs/Glossario/property/CSS	/pt-BR/docs/Glossary/property/CSS
/pt-BR/docs/Glossario/property/JavaScript	/pt-BR/docs/Glossary/property/JavaScript
/pt-BR/docs/Glossario/seguro	/pt-BR/docs/Glossary/safe
/pt-BR/docs/Glossario/topico_de_alinhamento	/pt-BR/docs/Glossary/Alignment_Subject
/pt-BR/docs/Glossario/undefined	/pt-BR/docs/Glossary/undefined
/pt-BR/docs/Glossario/webp	/pt-BR/docs/Glossary/webp
/pt-BR/docs/Guia_do_Desenvolvedor	/pt-BR/docs/Mozilla/Developer_guide
/pt-BR/docs/HTML	/pt-BR/docs/Web/HTML
/pt-BR/docs/HTML/Attributes	/pt-BR/docs/Web/HTML/Attributes
/pt-BR/docs/HTML/Canvas	/pt-BR/docs/Web/API/Canvas_API
/pt-BR/docs/HTML/Dicas_para_criar_páginas_HTML_de_carregamento_rápido	/pt-BR/docs/Learn/HTML/Howto/Author_fast-loading_HTML_pages
/pt-BR/docs/HTML/Element	/pt-BR/docs/Web/HTML/Element
/pt-BR/docs/HTML/Element-redirect-1	/pt-BR/docs/Web/HTML/Element
/pt-BR/docs/HTML/Element/Audio	/pt-BR/docs/Web/HTML/Element/Audio
/pt-BR/docs/HTML/Element/Input	/pt-BR/docs/Web/HTML/Element/Input
/pt-BR/docs/HTML/Element/Output	/pt-BR/docs/Web/HTML/Element/Output
/pt-BR/docs/HTML/Element/Source	/pt-BR/docs/Web/HTML/Element/Source
/pt-BR/docs/HTML/Element/Video	/pt-BR/docs/Web/HTML/Element/Video
/pt-BR/docs/HTML/Element/a	/pt-BR/docs/Web/HTML/Element/a
/pt-BR/docs/HTML/Element/abbr	/pt-BR/docs/Web/HTML/Element/abbr
/pt-BR/docs/HTML/Element/acronym	/pt-BR/docs/Web/HTML/Element/acronym
/pt-BR/docs/HTML/Element/address	/pt-BR/docs/Web/HTML/Element/address
/pt-BR/docs/HTML/Element/area	/pt-BR/docs/Web/HTML/Element/area
/pt-BR/docs/HTML/Element/article	/pt-BR/docs/Web/HTML/Element/article
/pt-BR/docs/HTML/Element/aside	/pt-BR/docs/Web/HTML/Element/aside
/pt-BR/docs/HTML/Element/canvas	/pt-BR/docs/Web/HTML/Element/canvas
/pt-BR/docs/HTML/Element/command	/pt-BR/docs/orphaned/Web/HTML/Element/command
/pt-BR/docs/HTML/Element/data	/pt-BR/docs/Web/HTML/Element/data
/pt-BR/docs/HTML/Element/datalist	/pt-BR/docs/Web/HTML/Element/datalist
/pt-BR/docs/HTML/Element/details	/pt-BR/docs/Web/HTML/Element/details
/pt-BR/docs/HTML/Element/dfn	/pt-BR/docs/Web/HTML/Element/dfn
/pt-BR/docs/HTML/Element/dl	/pt-BR/docs/Web/HTML/Element/dl
/pt-BR/docs/HTML/Element/figura	/pt-BR/docs/Web/HTML/Element/figure
/pt-BR/docs/HTML/Element/footer	/pt-BR/docs/Web/HTML/Element/footer
/pt-BR/docs/HTML/Element/footer-redirect-1	/pt-BR/docs/Web/HTML/Element/footer
/pt-BR/docs/HTML/Element/form	/pt-BR/docs/Web/HTML/Element/form
/pt-BR/docs/HTML/Element/header	/pt-BR/docs/Web/HTML/Element/header
/pt-BR/docs/HTML/Element/html	/pt-BR/docs/Web/HTML/Element/html
/pt-BR/docs/HTML/Element/ins	/pt-BR/docs/Web/HTML/Element/ins
/pt-BR/docs/HTML/Element/map	/pt-BR/docs/Web/HTML/Element/map
/pt-BR/docs/HTML/Element/mark	/pt-BR/docs/Web/HTML/Element/mark
/pt-BR/docs/HTML/Element/meter	/pt-BR/docs/Web/HTML/Element/meter
/pt-BR/docs/HTML/Element/nav	/pt-BR/docs/Web/HTML/Element/nav
/pt-BR/docs/HTML/Element/optgroup	/pt-BR/docs/Web/HTML/Element/optgroup
/pt-BR/docs/HTML/Element/progress	/pt-BR/docs/Web/HTML/Element/progress
/pt-BR/docs/HTML/Element/rt	/pt-BR/docs/Web/HTML/Element/rt
/pt-BR/docs/HTML/Element/ruby	/pt-BR/docs/Web/HTML/Element/ruby
/pt-BR/docs/HTML/Element/section	/pt-BR/docs/Web/HTML/Element/section
/pt-BR/docs/HTML/Element/span	/pt-BR/docs/Web/HTML/Element/span
/pt-BR/docs/HTML/Element/summary	/pt-BR/docs/Web/HTML/Element/summary
/pt-BR/docs/HTML/Element/table	/pt-BR/docs/Web/HTML/Element/table
/pt-BR/docs/HTML/Element/wbr	/pt-BR/docs/Web/HTML/Element/wbr
/pt-BR/docs/HTML/Elementos HTML	/pt-BR/docs/Web/HTML/Element
/pt-BR/docs/HTML/Forms_in_HTML	/pt-BR/docs/orphaned/Learn/HTML/Forms/HTML5_updates
/pt-BR/docs/HTML/Formularios_em_HTML	/pt-BR/docs/orphaned/Learn/HTML/Forms/HTML5_updates
/pt-BR/docs/HTML/HTML5	/pt-BR/docs/Web/Guide/HTML/HTML5
/pt-BR/docs/HTML/HTML5/HTML5_element_list	/pt-BR/docs/Web/HTML/Element
/pt-BR/docs/HTML/HTML5/Introduction_to_HTML5	/pt-BR/docs/Web/Guide/HTML/HTML5/Introduction_to_HTML5
/pt-BR/docs/HTML/HTML5/Introdução_ao_HTML5	/pt-BR/docs/Web/Guide/HTML/HTML5/Introduction_to_HTML5
/pt-BR/docs/HTML/HTML_Elements	/pt-BR/docs/Web/HTML/Element
/pt-BR/docs/HTML/HTML_Elements/time	/pt-BR/docs/Web/HTML/Element/time
/pt-BR/docs/HTML/Introducao	/pt-BR/docs/Learn/HTML/Introduction_to_HTML
/pt-BR/docs/HTML/Introduction	/pt-BR/docs/Learn/HTML/Introduction_to_HTML
/pt-BR/docs/HTML/Optimizing_Your_Pages_for_Speculative_Parsing	/pt-BR/docs/Glossary/speculative_parsing
/pt-BR/docs/HTML/Using_the_application_cache	/pt-BR/docs/Web/HTML/Using_the_application_cache
/pt-BR/docs/Hello_World_Rust	/pt-BR/docs/orphaned/Hello_World_Rust
/pt-BR/docs/IndexedDB	/pt-BR/docs/Web/API/IndexedDB_API
/pt-BR/docs/IndexedDB/Basic_Concepts_Behind_IndexedDB	/pt-BR/docs/Web/API/IndexedDB_API/Basic_Concepts_Behind_IndexedDB
/pt-BR/docs/IndexedDB/Usando_IndexedDB	/pt-BR/docs/Web/API/IndexedDB_API/Using_IndexedDB
/pt-BR/docs/Instalando_Rust	/pt-BR/docs/orphaned/Instalando_Rust
/pt-BR/docs/JSON	/pt-BR/docs/Glossary/JSON
/pt-BR/docs/JavaScript	/pt-BR/docs/Web/JavaScript
/pt-BR/docs/JavaScript/A_re-introduction_to_JavaScript	/pt-BR/docs/Web/JavaScript/A_re-introduction_to_JavaScript
/pt-BR/docs/JavaScript/About_JavaScript	/pt-BR/docs/Web/JavaScript/About_JavaScript
/pt-BR/docs/JavaScript/Data_structures	/pt-BR/docs/Web/JavaScript/Data_structures
/pt-BR/docs/JavaScript/Guide	/pt-BR/docs/Web/JavaScript/Guide
/pt-BR/docs/JavaScript/Guide/About	/pt-BR/docs/Web/JavaScript/Guide/Introduction
/pt-BR/docs/JavaScript/Guide/Closures	/pt-BR/docs/Web/JavaScript/Closures
/pt-BR/docs/JavaScript/Guide/Detalhes_do_Modelo_do_Objeto	/pt-BR/docs/Web/JavaScript/Guide/Details_of_the_Object_Model
/pt-BR/docs/JavaScript/Guide/Expressions_and_Operators	/pt-BR/docs/Web/JavaScript/Guide/Expressions_and_Operators
/pt-BR/docs/JavaScript/Guide/Herança_Revisitada	/pt-BR/docs/Web/JavaScript/Inheritance_and_the_prototype_chain
/pt-BR/docs/JavaScript/Guide/Igualdade	/pt-BR/docs/conflicting/Web/JavaScript/Equality_comparisons_and_sameness
/pt-BR/docs/JavaScript/Guide/Inheritance_Revisited	/pt-BR/docs/Web/JavaScript/Inheritance_and_the_prototype_chain
/pt-BR/docs/JavaScript/Guide/JavaScript_Visão_Geral	/pt-BR/docs/Web/JavaScript/Guide/Introduction
/pt-BR/docs/JavaScript/Guide/Regular_Expressions	/pt-BR/docs/Web/JavaScript/Guide/Regular_Expressions
/pt-BR/docs/JavaScript/Guide/Trabalhando_com_Objetos	/pt-BR/docs/Web/JavaScript/Guide/Working_with_Objects
/pt-BR/docs/JavaScript/Guide/Valores,_variáveis_e_literais	/pt-BR/docs/Web/JavaScript/Guide/Grammar_and_types
/pt-BR/docs/JavaScript/Guide/Values,_variables,_and_literals	/pt-BR/docs/Web/JavaScript/Guide/Grammar_and_types
/pt-BR/docs/JavaScript/Introduction_to_Object-Oriented_JavaScript	/pt-BR/docs/conflicting/Learn/JavaScript/Objects
/pt-BR/docs/JavaScript/JavaScript_technologies_overview	/pt-BR/docs/Web/JavaScript/JavaScript_technologies_overview
/pt-BR/docs/JavaScript/Outras_ferramentas_JavaScript	/pt-BR/docs/Tools
/pt-BR/docs/JavaScript/Reference	/pt-BR/docs/Web/JavaScript/Reference
/pt-BR/docs/JavaScript/Reference/About	/pt-BR/docs/Web/JavaScript/Reference/About
/pt-BR/docs/JavaScript/Reference/Global_Objects	/pt-BR/docs/Web/JavaScript/Reference/Global_Objects
/pt-BR/docs/JavaScript/Reference/Global_Objects/Array	/pt-BR/docs/Web/JavaScript/Reference/Global_Objects/Array
/pt-BR/docs/JavaScript/Reference/Global_Objects/Array/concat	/pt-BR/docs/Web/JavaScript/Reference/Global_Objects/Array/concat
/pt-BR/docs/JavaScript/Reference/Global_Objects/Array/forEach	/pt-BR/docs/Web/JavaScript/Reference/Global_Objects/Array/forEach
/pt-BR/docs/JavaScript/Reference/Global_Objects/Array/splice	/pt-BR/docs/Web/JavaScript/Reference/Global_Objects/Array/splice
/pt-BR/docs/JavaScript/Reference/Global_Objects/Date	/pt-BR/docs/Web/JavaScript/Reference/Global_Objects/Date
/pt-BR/docs/JavaScript/Reference/Global_Objects/Math	/pt-BR/docs/Web/JavaScript/Reference/Global_Objects/Math
/pt-BR/docs/JavaScript/Reference/Global_Objects/Math/exp	/pt-BR/docs/Web/JavaScript/Reference/Global_Objects/Math/exp
/pt-BR/docs/JavaScript/Reference/Global_Objects/Math/floor	/pt-BR/docs/Web/JavaScript/Reference/Global_Objects/Math/floor
/pt-BR/docs/JavaScript/Reference/Global_Objects/Math/sqrt	/pt-BR/docs/Web/JavaScript/Reference/Global_Objects/Math/sqrt
/pt-BR/docs/JavaScript/Reference/Global_Objects/Object	/pt-BR/docs/Web/JavaScript/Reference/Global_Objects/Object
/pt-BR/docs/JavaScript/Reference/Global_Objects/Object/hasOwnProperty	/pt-BR/docs/Web/JavaScript/Reference/Global_Objects/Object/hasOwnProperty
/pt-BR/docs/JavaScript/Reference/Global_Objects/Objetos	/pt-BR/docs/Web/JavaScript/Reference/Global_Objects/Object
/pt-BR/docs/JavaScript/Reference/Global_Objects/Objetos/hasOwnProperty	/pt-BR/docs/Web/JavaScript/Reference/Global_Objects/Object/hasOwnProperty
/pt-BR/docs/JavaScript/Reference/Global_Objects/String	/pt-BR/docs/Web/JavaScript/Reference/Global_Objects/String
/pt-BR/docs/JavaScript/Reference/Global_Objects/String/indexOf	/pt-BR/docs/Web/JavaScript/Reference/Global_Objects/String/indexOf
/pt-BR/docs/JavaScript/Reference/Global_Objects/WeakMap	/pt-BR/docs/Web/JavaScript/Reference/Global_Objects/WeakMap
/pt-BR/docs/JavaScript/Reference/Global_Objects/WeakMap/prototype	/pt-BR/docs/conflicting/Web/JavaScript/Reference/Global_Objects/WeakMap
/pt-BR/docs/JavaScript/Reference/Global_Objects/isNaN	/pt-BR/docs/Web/JavaScript/Reference/Global_Objects/isNaN
/pt-BR/docs/JavaScript/Reference/Global_Objects/parseInt	/pt-BR/docs/Web/JavaScript/Reference/Global_Objects/parseInt
/pt-BR/docs/JavaScript/Reference/Operators	/pt-BR/docs/Web/JavaScript/Reference/Operators
/pt-BR/docs/JavaScript/Reference/Operators/Operador_Virgula	/pt-BR/docs/Web/JavaScript/Reference/Operators/Comma_Operator
/pt-BR/docs/JavaScript/Reference/Operators/typeof	/pt-BR/docs/Web/JavaScript/Reference/Operators/typeof
/pt-BR/docs/JavaScript/Reference/Statements	/pt-BR/docs/Web/JavaScript/Reference/Statements
/pt-BR/docs/JavaScript/Reference/Statements/label	/pt-BR/docs/Web/JavaScript/Reference/Statements/label
/pt-BR/docs/JavaScript/Reference/Statements/let	/pt-BR/docs/Web/JavaScript/Reference/Statements/let
/pt-BR/docs/JavaScript/uma_reintroduction_ao_JavaScript	/pt-BR/docs/Web/JavaScript/A_re-introduction_to_JavaScript
/pt-BR/docs/Learn/Accessibility/Acessibilidade_problemas	/pt-BR/docs/Learn/Accessibility/Accessibility_troubleshooting
/pt-BR/docs/Learn/Accessibility/CSS_e_JavaScript	/pt-BR/docs/Learn/Accessibility/CSS_and_JavaScript
/pt-BR/docs/Learn/CSS/CSS_layout/Fluxo_Normal	/pt-BR/docs/Learn/CSS/CSS_layout/Normal_Flow
/pt-BR/docs/Learn/CSS/CSS_layout/Intro_leiaute_CSS	/pt-BR/docs/Learn/CSS/CSS_layout/Introduction
/pt-BR/docs/Learn/CSS/CSS_layout/Layout_de_varias_colunas	/pt-BR/docs/Learn/CSS/CSS_layout/Multiple-column_Layout
/pt-BR/docs/Learn/CSS/First_steps/Como_CSS_e_estruturado	/pt-BR/docs/Learn/CSS/First_steps/How_CSS_is_structured
/pt-BR/docs/Learn/CSS/First_steps/Iniciando	/pt-BR/docs/Learn/CSS/First_steps/Getting_started
/pt-BR/docs/Learn/CSS/First_steps/O_que_e_CSS	/pt-BR/docs/Learn/CSS/First_steps/What_is_CSS
/pt-BR/docs/Learn/CSS/Howto/CSS_Perguntas_Frequentes	/pt-BR/docs/Learn/CSS/Howto/CSS_FAQ
/pt-BR/docs/Learn/Common_questions/Como_a_internet_funciona	/pt-BR/docs/Learn/Common_questions/How_does_the_Internet_work
/pt-BR/docs/Learn/Common_questions/Como_configurar_um_servidor_de_testes_local	/pt-BR/docs/Learn/Common_questions/set_up_a_local_testing_server
/pt-BR/docs/Learn/Common_questions/Como_voce_hospeda_seu_site_Google_App_Engine	/pt-BR/docs/Learn/Common_questions/How_do_you_host_your_website_on_Google_App_Engine
/pt-BR/docs/Learn/Common_questions/O_que_são_hyperlinks	/pt-BR/docs/Learn/Common_questions/What_are_hyperlinks
/pt-BR/docs/Learn/Common_questions/Pensando_antes_de_codificar	/pt-BR/docs/Learn/Common_questions/Thinking_before_coding
/pt-BR/docs/Learn/Common_questions/Quanto_custa_fazer_algo_web	/pt-BR/docs/Learn/Common_questions/How_much_does_it_cost
/pt-BR/docs/Learn/Common_questions/Que_software_eu_preciso	/pt-BR/docs/Learn/Common_questions/What_software_do_I_need
/pt-BR/docs/Learn/Common_questions/ferramentas_de_desenvolvimento_do_navegador	/pt-BR/docs/Learn/Common_questions/What_are_browser_developer_tools
/pt-BR/docs/Learn/Common_questions/o_que_e_um_web_server	/pt-BR/docs/Learn/Common_questions/What_is_a_web_server
/pt-BR/docs/Learn/JavaScript/Asynchronous/Conceitos	/pt-BR/docs/Learn/JavaScript/Asynchronous/Concepts
/pt-BR/docs/Learn/JavaScript/Asynchronous/Escolhendo_abordagem_correta	/pt-BR/docs/Learn/JavaScript/Asynchronous/Choosing_the_right_approach
/pt-BR/docs/Learn/JavaScript/Asynchronous/Introdução	/pt-BR/docs/Learn/JavaScript/Asynchronous/Introducing
/pt-BR/docs/Learn/JavaScript/First_steps/Gerador_de_historias_bobas	/pt-BR/docs/Learn/JavaScript/First_steps/Silly_story_generator
/pt-BR/docs/Learn/JavaScript/First_steps/Matematica	/pt-BR/docs/Learn/JavaScript/First_steps/Math
/pt-BR/docs/Learn/JavaScript/First_steps/O_que_e_JavaScript	/pt-BR/docs/Learn/JavaScript/First_steps/What_is_JavaScript
/pt-BR/docs/Learn/JavaScript/First_steps/Teste_suas_habilidades:_variaveis	/pt-BR/docs/Learn/JavaScript/First_steps/Test_your_skills:_variables
/pt-BR/docs/Learn/JavaScript/First_steps/Variáveis	/pt-BR/docs/Learn/JavaScript/First_steps/Variables
/pt-BR/docs/Learn/Server-side/Django/Hospedagem	/pt-BR/docs/Learn/Server-side/Django/Deployment
/pt-BR/docs/Learn/Server-side/Django/Introdução	/pt-BR/docs/Learn/Server-side/Django/Introduction
/pt-BR/docs/Learn/Server-side/Django/Sessões	/pt-BR/docs/Learn/Server-side/Django/Sessions
/pt-BR/docs/Learn/Server-side/Django/Tutorial_website_biblioteca_local	/pt-BR/docs/Learn/Server-side/Django/Tutorial_local_library_website
/pt-BR/docs/Learn/Server-side/Django/ambiente_de_desenvolvimento	/pt-BR/docs/Learn/Server-side/Django/development_environment
/pt-BR/docs/Learn/Server-side/Express_Nodejs/Introdução	/pt-BR/docs/Learn/Server-side/Express_Nodejs/Introduction
/pt-BR/docs/Learn/Server-side/Express_Nodejs/ambiente_de_desenvolvimento	/pt-BR/docs/Learn/Server-side/Express_Nodejs/development_environment
/pt-BR/docs/Learn/Server-side/First_steps/Introdução	/pt-BR/docs/Learn/Server-side/First_steps/Introduction
/pt-BR/docs/Learn/Server-side/First_steps/Seguranca_site	/pt-BR/docs/Learn/Server-side/First_steps/Website_security
/pt-BR/docs/Learn/Tools_and_testing/Client-side_JavaScript_frameworks/Comecando_com_React	/pt-BR/docs/Learn/Tools_and_testing/Client-side_JavaScript_frameworks/React_getting_started
/pt-BR/docs/Learn/Tools_and_testing/Client-side_JavaScript_frameworks/Vue_iniciando	/pt-BR/docs/Learn/Tools_and_testing/Client-side_JavaScript_frameworks/Vue_getting_started
/pt-BR/docs/Localização	/pt-BR/docs/Glossary/Localization
/pt-BR/docs/MDN/Comunidade	/pt-BR/docs/orphaned/MDN/Community
/pt-BR/docs/MDN/Comunidade/Trabalhando_em_comunidade	/pt-BR/docs/orphaned/MDN/Community/Working_in_community
/pt-BR/docs/MDN/Comunidade/Whats_happening	/pt-BR/docs/orphaned/MDN/Community/Whats_happening
/pt-BR/docs/MDN/Contribute/Collaboration_tactics	/pt-BR/docs/orphaned/MDN/Contribute/Processes/Cross-team_collaboration_tactics
/pt-BR/docs/MDN/Contribute/Content	/pt-BR/docs/MDN/Guidelines
/pt-BR/docs/MDN/Contribute/Content/Style_guide	/pt-BR/docs/MDN/Guidelines/Writing_style_guide
/pt-BR/docs/MDN/Contribute/Editor	/pt-BR/docs/orphaned/MDN/Editor
/pt-BR/docs/MDN/Contribute/Editor/Basics	/pt-BR/docs/orphaned/MDN/Editor/Basics
/pt-BR/docs/MDN/Contribute/Estruturas	/pt-BR/docs/MDN/Structures
/pt-BR/docs/MDN/Contribute/Estruturas/Compatibility_tables	/pt-BR/docs/MDN/Structures/Compatibility_tables
/pt-BR/docs/MDN/Contribute/Estruturas/Macros	/pt-BR/docs/MDN/Structures/Macros
/pt-BR/docs/MDN/Contribute/Processos	/pt-BR/docs/MDN/Contribute/Processes
/pt-BR/docs/MDN/Contribute/Tools	/pt-BR/docs/MDN/Tools
/pt-BR/docs/MDN/Contribute/Tools/KumaScript	/pt-BR/docs/MDN/Tools/KumaScript
/pt-BR/docs/MDN/Contribute/Tools/KumaScript/Solucionando_problemas_de_erros_de_KumaScript	/pt-BR/docs/MDN/Tools/KumaScript/Troubleshooting
/pt-BR/docs/MDN/Contribute/Tools/Page_regeneration	/pt-BR/docs/orphaned/MDN/Tools/Page_regeneration
/pt-BR/docs/MDN/Contribute/criando_e_editando_paginas	/pt-BR/docs/MDN/Contribute/Howto/Create_and_edit_pages
/pt-BR/docs/MDN/Contribute/guia	/pt-BR/docs/MDN/Contribute/Howto
/pt-BR/docs/MDN/Contribute/guia/Como-marcar-as-paginas-corretamente	/pt-BR/docs/MDN/Contribute/Howto/Tag
/pt-BR/docs/MDN/Contribute/guia/Converter_exemplos_codigo_para_ao_vivo	/pt-BR/docs/MDN/Contribute/Howto/Convert_code_samples_to_be_live
/pt-BR/docs/MDN/Contribute/guia/Create_an_MDN_account	/pt-BR/docs/orphaned/MDN/Contribute/Howto/Create_an_MDN_account
/pt-BR/docs/MDN/Contribute/guia/Create_an_interactive_exercise_to_help_learning_the_web	/pt-BR/docs/MDN/Contribute/Howto/Create_an_interactive_exercise_to_help_learning_the_web
/pt-BR/docs/MDN/Contribute/guia/Create_an_interactive_exercise_to_help_learning_the_web/distant_example	/pt-BR/docs/MDN/Contribute/Howto/Create_an_interactive_exercise_to_help_learning_the_web/distant_example
/pt-BR/docs/MDN/Contribute/guia/Do_a_technical_review	/pt-BR/docs/orphaned/MDN/Contribute/Howto/Do_a_technical_review
/pt-BR/docs/MDN/Contribute/guia/Do_an_editorial_review	/pt-BR/docs/orphaned/MDN/Contribute/Howto/Do_an_editorial_review
/pt-BR/docs/MDN/Contribute/guia/Escreva_um_artigo_para_ajudar_aprender_sobre_a_Web	/pt-BR/docs/orphaned/MDN/Contribute/Howto/Write_an_article_to_help_learn_about_the_Web
/pt-BR/docs/MDN/Contribute/guia/Set_the_summary_for_a_page	/pt-BR/docs/orphaned/MDN/Contribute/Howto/Set_the_summary_for_a_page
/pt-BR/docs/MDN/Contribute/guia/Tag_JavaScript_pages	/pt-BR/docs/orphaned/MDN/Contribute/Howto/Tag_JavaScript_pages
/pt-BR/docs/MDN/Editor	/pt-BR/docs/orphaned/MDN/Editor
/pt-BR/docs/MDN/Editor/Basics	/pt-BR/docs/orphaned/MDN/Editor/Basics
/pt-BR/docs/MDN/Feedback	/pt-BR/docs/MDN/Contribute/Feedback
/pt-BR/docs/MDN/Guidelines/Style_guide	/pt-BR/docs/MDN/Guidelines/Writing_style_guide
/pt-BR/docs/MDN/Kuma	/pt-BR/docs/MDN/Yari
/pt-BR/docs/MDN/Paineis	/pt-BR/docs/orphaned/MDN/Dashboards
/pt-BR/docs/MDN/Primeiros_Passos	/pt-BR/docs/MDN/Contribute/Getting_started
/pt-BR/docs/MDN/Tools/KumaScript/Solucionando_problemas_de_erros_de_KumaScript	/pt-BR/docs/MDN/Tools/KumaScript/Troubleshooting
/pt-BR/docs/MDN/Tools/Page_regeneration	/pt-BR/docs/orphaned/MDN/Tools/Page_regeneration
/pt-BR/docs/MDN/guia_usuário	/pt-BR/docs/MDN/Tools
/pt-BR/docs/Mozilla/Add-ons/WebExtensions/API/tema	/pt-BR/docs/Mozilla/Add-ons/WebExtensions/API/theme
/pt-BR/docs/Mozilla/Add-ons/WebExtensions/Anatomia_de_uma_WebExtension	/pt-BR/docs/Mozilla/Add-ons/WebExtensions/Anatomy_of_a_WebExtension
/pt-BR/docs/Mozilla/Add-ons/WebExtensions/Empacotando_e_instalando	/pt-BR/docs/orphaned/Mozilla/Add-ons/WebExtensions/Temporary_Installation_in_Firefox
/pt-BR/docs/Mozilla/Add-ons/WebExtensions/O_que_vem_a_seguir_	/pt-BR/docs/Mozilla/Add-ons/WebExtensions/What_next_
/pt-BR/docs/Mozilla/Add-ons/WebExtensions/Passo-a-Passo	/pt-BR/docs/Mozilla/Add-ons/WebExtensions/Your_second_WebExtension
/pt-BR/docs/Mozilla/Add-ons/WebExtensions/manifest.json/permissões	/pt-BR/docs/Mozilla/Add-ons/WebExtensions/manifest.json/permissions
/pt-BR/docs/Mozilla/Add-ons/WebExtensions/pre-requisitos	/pt-BR/docs/Mozilla/Add-ons/WebExtensions/Prerequisites
/pt-BR/docs/Mozilla/Add-ons/WebExtensions/sua_primeira_WebExtension	/pt-BR/docs/Mozilla/Add-ons/WebExtensions/Your_first_WebExtension
/pt-BR/docs/Mozilla/Add-ons/WebExtensions/user_interface/Itens_do_menu_de_contexto	/pt-BR/docs/Mozilla/Add-ons/WebExtensions/user_interface/Context_menu_items
/pt-BR/docs/Mozilla/Developer_guide/Codigo_Fonte	/pt-BR/docs/Mozilla/Developer_guide/Source_Code
/pt-BR/docs/Mozilla/Firefox/Novas_funcionalidades	/pt-BR/docs/Mozilla/Firefox/Experimental_features
/pt-BR/docs/Mozilla/Firefox/Releases/3/Zoom_de_página_inteira	/pt-BR/docs/Mozilla/Firefox/Releases/3/Full_page_zoom
/pt-BR/docs/Online_and_offline_events	/pt-BR/docs/Web/API/NavigatorOnLine/Online_and_offline_events
/pt-BR/docs/Projeto:Como_ajudar_com_MDN	/pt-BR/docs/conflicting/MDN/Contribute/Getting_started
/pt-BR/docs/Projeto:Como_ajudar_com_MDN-redirect-1	/pt-BR/docs/conflicting/MDN/Contribute/Getting_started
/pt-BR/docs/Projeto:Como_ajudar_com_MDN-redirect-2	/pt-BR/docs/conflicting/MDN/Contribute/Getting_started
/pt-BR/docs/Quirks_Mode_and_Standards_Mode	/pt-BR/docs/Web/HTML/Quirks_Mode_and_Standards_Mode
/pt-BR/docs/SVG	/pt-BR/docs/Web/SVG
/pt-BR/docs/SVG/Element	/pt-BR/docs/Web/SVG/Element
/pt-BR/docs/SVG/Element/desc	/pt-BR/docs/Web/SVG/Element/desc
/pt-BR/docs/SVG/Element/svg	/pt-BR/docs/Web/SVG/Element/svg
/pt-BR/docs/SVG/Element/texto	/pt-BR/docs/Web/SVG/Element/text
/pt-BR/docs/Sections_and_Outlines_of_an_HTML5_document	/pt-BR/docs/Web/Guide/HTML/Using_HTML_sections_and_outlines
/pt-BR/docs/Security/CSP/Utilizando_Politicas_De_Seguranca_De_Conteudo	/pt-BR/docs/Web/HTTP/CSP
/pt-BR/docs/Seções_e_estrutura_HTML5	/pt-BR/docs/Web/Guide/HTML/Using_HTML_sections_and_outlines
/pt-BR/docs/The_XSLT_JavaScript_Interface_in_Gecko	/pt-BR/docs/Web/XSLT/XSLT_JS_interface_in_Gecko
/pt-BR/docs/The_XSLT_JavaScript_Interface_in_Gecko/Advanced_Example	/pt-BR/docs/Web/XSLT/XSLT_JS_interface_in_Gecko/Advanced_Example
/pt-BR/docs/Tools/Add-ons	/pt-BR/docs/orphaned/Tools/Add-ons
/pt-BR/docs/Tools/Add-ons/DOM_Inspector_Pt-Br	/pt-BR/docs/orphaned/Tools/Add-ons/DOM_Inspector
/pt-BR/docs/Tools/CSS_Coverage	/pt-BR/docs/orphaned/Tools/CSS_Coverage
/pt-BR/docs/Tools/Debugger/How_to/Examine,_modify,_and_watch_variables	/pt-BR/docs/Tools/Debugger/How_to/Set_Watch_Expressions
/pt-BR/docs/Tools/Debugger_(before_Firefox_52)	/pt-BR/docs/orphaned/Tools/Debugger_(before_Firefox_52)
/pt-BR/docs/Tools/Debugger_(before_Firefox_52)/Disable_breakpoints	/pt-BR/docs/orphaned/Tools/Debugger_(before_Firefox_52)/Disable_breakpoints
/pt-BR/docs/Tools/Depurador	/pt-BR/docs/Tools/Debugger
/pt-BR/docs/Tools/Depurador/Set_a_logpoint	/pt-BR/docs/Tools/Debugger/Set_a_logpoint
/pt-BR/docs/Tools/Depuração_Remota	/pt-BR/docs/Tools/Remote_Debugging
/pt-BR/docs/Tools/Editor_de_Estilos	/pt-BR/docs/Tools/Style_Editor
/pt-BR/docs/Tools/Inspetor_de_Armazenamento	/pt-BR/docs/Tools/Storage_Inspector
/pt-BR/docs/Tools/Medir_uma_porcao_da_pagina	/pt-BR/docs/Tools/Measure_a_portion_of_the_page
/pt-BR/docs/Tools/Modo_Design_Adaptavel	/pt-BR/docs/Tools/Responsive_Design_Mode
/pt-BR/docs/Tools/Notas_de_lancamento	/pt-BR/docs/conflicting/Mozilla/Firefox/Releases
/pt-BR/docs/Tools/Page_Inspector/How_to/Examinando_eventos_escuta	/pt-BR/docs/Tools/Page_Inspector/How_to/Examine_event_listeners
/pt-BR/docs/Tools/Page_Inspector/How_to/Trabalho_Com_Animaçoes	/pt-BR/docs/Tools/Page_Inspector/How_to/Work_with_animations
/pt-BR/docs/Tools/Simulador_Firefox_OS_1.1	/pt-BR/docs/Tools/Firefox_OS_1.1_Simulator
/pt-BR/docs/Tools/Web_Console/Opening_the_Web_Console	/pt-BR/docs/Tools/Web_Console/UI_Tour
/pt-BR/docs/Tools/atuação	/pt-BR/docs/Tools/Performance
/pt-BR/docs/Using_HTML5_audio_and_video	/pt-BR/docs/conflicting/Learn/HTML/Multimedia_and_embedding/Video_and_audio_content
/pt-BR/docs/Using_files_from_web_applications	/pt-BR/docs/Web/API/File/Using_files_from_web_applications
/pt-BR/docs/Using_geolocation	/pt-BR/docs/Web/API/Geolocation_API
/pt-BR/docs/Utilizando_áudio_e_vídeo_com_HTML5	/pt-BR/docs/conflicting/Learn/HTML/Multimedia_and_embedding/Video_and_audio_content
/pt-BR/docs/Web/API/API_Push	/pt-BR/docs/Web/API/Push_API
/pt-BR/docs/Web/API/API_Push/Best_Practices	/pt-BR/docs/Web/API/Push_API/Best_Practices
/pt-BR/docs/Web/API/API_Web_Audio	/pt-BR/docs/Web/API/Web_Audio_API
/pt-BR/docs/Web/API/API_Web_Audio/Sintetizador_simples	/pt-BR/docs/Web/API/Web_Audio_API/Simple_synth
/pt-BR/docs/Web/API/API_de_Desempenho	/pt-BR/docs/Web/API/Performance_API
/pt-BR/docs/Web/API/ArrayBuffer	/pt-BR/docs/Web/JavaScript/Reference/Global_Objects/ArrayBuffer
/pt-BR/docs/Web/API/AudioContext/currentTime	/pt-BR/docs/Web/API/BaseAudioContext/currentTime
/pt-BR/docs/Web/API/BatteryManager.charging	/pt-BR/docs/Web/API/BatteryManager/charging
/pt-BR/docs/Web/API/BatteryManager.chargingTime	/pt-BR/docs/Web/API/BatteryManager/chargingTime
/pt-BR/docs/Web/API/BatteryManager.dischargingTime	/pt-BR/docs/Web/API/BatteryManager/dischargingTime
/pt-BR/docs/Web/API/BatteryManager.level	/pt-BR/docs/Web/API/BatteryManager/level
/pt-BR/docs/Web/API/BatteryManager.onchargingchange	/pt-BR/docs/Web/API/BatteryManager/onchargingchange
/pt-BR/docs/Web/API/BatteryManager.onchargingtimechange	/pt-BR/docs/Web/API/BatteryManager/onchargingtimechange
/pt-BR/docs/Web/API/BatteryManager.ondischargingtimechange	/pt-BR/docs/Web/API/BatteryManager/ondischargingtimechange
/pt-BR/docs/Web/API/BatteryManager.onlevelchange	/pt-BR/docs/Web/API/BatteryManager/onlevelchange
/pt-BR/docs/Web/API/BatteryManager/ondischargintimechange	/pt-BR/docs/Web/API/BatteryManager/ondischargingtimechange
/pt-BR/docs/Web/API/Console.timeEnd	/pt-BR/docs/Web/API/Console/timeEnd
/pt-BR/docs/Web/API/Coordinates	/pt-BR/docs/Web/API/GeolocationCoordinates
/pt-BR/docs/Web/API/Coordinates/altitude	/pt-BR/docs/Web/API/GeolocationCoordinates/altitude
/pt-BR/docs/Web/API/CryptoKey/algorithm	/pt-BR/docs/conflicting/Web/API/CryptoKey
/pt-BR/docs/Web/API/CryptoKey/extractable	/pt-BR/docs/conflicting/Web/API/CryptoKey_53ae81677f4d9298717f2f245ae4da0d
/pt-BR/docs/Web/API/CryptoKey/type	/pt-BR/docs/conflicting/Web/API/CryptoKey_33bd21ca8f20b4cd8c7b8c762e2fc597
/pt-BR/docs/Web/API/CryptoKey/usages	/pt-BR/docs/conflicting/Web/API/CryptoKey_f39d256ef7fbd1cf0a1f26de1e887ae7
/pt-BR/docs/Web/API/DeviceAcceleration	/pt-BR/docs/Web/API/DeviceMotionEventAcceleration
/pt-BR/docs/Web/API/DeviceRotationRate	/pt-BR/docs/Web/API/DeviceMotionEventRotationRate
/pt-BR/docs/Web/API/Document.querySelector	/pt-BR/docs/Web/API/Document/querySelector
/pt-BR/docs/Web/API/Document.querySelectorAll	/pt-BR/docs/Web/API/Document/querySelectorAll
/pt-BR/docs/Web/API/Document/ElementoRegistrado	/pt-BR/docs/Web/API/Document/registerElement
/pt-BR/docs/Web/API/Document/activeElement	/pt-BR/docs/Web/API/DocumentOrShadowRoot/activeElement
/pt-BR/docs/Web/API/Document/async	/pt-BR/docs/Web/API/XMLDocument/async
/pt-BR/docs/Web/API/Document/defaultView/popstate_event	/pt-BR/docs/Web/API/Window/popstate_event
/pt-BR/docs/Web/API/Document/defaultView/resize_event	/pt-BR/docs/Web/API/Window/resize_event
/pt-BR/docs/Web/API/Document/elementFromPoint	/pt-BR/docs/Web/API/DocumentOrShadowRoot/elementFromPoint
/pt-BR/docs/Web/API/Document/getSelection	/pt-BR/docs/Web/API/DocumentOrShadowRoot/getSelection
/pt-BR/docs/Web/API/DocumentoXML	/pt-BR/docs/Web/API/XMLDocument
/pt-BR/docs/Web/API/Element.addEventListener	/pt-BR/docs/Web/API/EventTarget/addEventListener
/pt-BR/docs/Web/API/Element.getAttribute	/pt-BR/docs/Web/API/Element/getAttribute
/pt-BR/docs/Web/API/Element.id	/pt-BR/docs/Web/API/Element/id
/pt-BR/docs/Web/API/Element.querySelector	/pt-BR/docs/Web/API/Element/querySelector
/pt-BR/docs/Web/API/Element.querySelectorAll	/pt-BR/docs/Web/API/Element/querySelectorAll
/pt-BR/docs/Web/API/Element.removeAttribute	/pt-BR/docs/Web/API/Element/removeAttribute
/pt-BR/docs/Web/API/Element/accessKey	/pt-BR/docs/Web/API/HTMLElement/accessKey
/pt-BR/docs/Web/API/Element/addEventListener	/pt-BR/docs/Web/API/EventTarget/addEventListener
/pt-BR/docs/Web/API/Element/name	/pt-BR/docs/conflicting/Web/API
/pt-BR/docs/Web/API/Event/Comparativo_entre_Event_Targets	/pt-BR/docs/Web/API/Event/Comparison_of_Event_Targets
/pt-BR/docs/Web/API/Fetch_API/Uso_de_busca_Cross-global	/pt-BR/docs/Web/API/Fetch_API/Cross-global_fetch_usage
/pt-BR/docs/Web/API/HTMLContentElement/Seletor	/pt-BR/docs/Web/API/HTMLContentElement/select
/pt-BR/docs/Web/API/HTMLElement/blur	/pt-BR/docs/Web/API/HTMLOrForeignElement/blur
/pt-BR/docs/Web/API/HTMLElement/dataset	/pt-BR/docs/Web/API/HTMLOrForeignElement/dataset
/pt-BR/docs/Web/API/HTMLElement/focus	/pt-BR/docs/Web/API/HTMLOrForeignElement/focus
/pt-BR/docs/Web/API/History_API/Exemplo	/pt-BR/docs/Web/API/History_API/Example
/pt-BR/docs/Web/API/IndexedDB_API/Usando_IndexedDB	/pt-BR/docs/Web/API/IndexedDB_API/Using_IndexedDB
/pt-BR/docs/Web/API/Navigator.battery	/pt-BR/docs/Web/API/Navigator/battery
/pt-BR/docs/Web/API/NavigatorID.platform	/pt-BR/docs/Web/API/NavigatorID/platform
/pt-BR/docs/Web/API/Node.appendChild	/pt-BR/docs/Web/API/Node/appendChild
/pt-BR/docs/Web/API/Node.childNodes	/pt-BR/docs/Web/API/Node/childNodes
/pt-BR/docs/Web/API/Node.contains	/pt-BR/docs/Web/API/Node/contains
/pt-BR/docs/Web/API/Node.insertBefore	/pt-BR/docs/Web/API/Node/insertBefore
/pt-BR/docs/Web/API/Node.nextSibling	/pt-BR/docs/Web/API/Node/nextSibling
/pt-BR/docs/Web/API/Node.previousSibling	/pt-BR/docs/Web/API/Node/previousSibling
/pt-BR/docs/Web/API/Node.removeChild	/pt-BR/docs/Web/API/Node/removeChild
/pt-BR/docs/Web/API/Node.replaceChild	/pt-BR/docs/Web/API/Node/replaceChild
/pt-BR/docs/Web/API/Node/Entendendo_o_uso_do_método_AppendChild-javascript	/pt-BR/docs/orphaned/Web/API/Node/Entendendo_o_uso_do_método_AppendChild-javascript
/pt-BR/docs/Web/API/Node/innerText	/pt-BR/docs/Web/API/HTMLElement/innerText
/pt-BR/docs/Web/API/Position	/pt-BR/docs/Web/API/GeolocationPosition
/pt-BR/docs/Web/API/Position/coords	/pt-BR/docs/Web/API/GeolocationPosition/coords
/pt-BR/docs/Web/API/PositionError	/pt-BR/docs/Web/API/GeolocationPositionError
/pt-BR/docs/Web/API/RandomSource	/pt-BR/docs/conflicting/Web/API/Crypto/getRandomValues
/pt-BR/docs/Web/API/RandomSource/getRandomValues	/pt-BR/docs/Web/API/Crypto/getRandomValues
/pt-BR/docs/Web/API/SVGAElement/SVGAlement.target	/pt-BR/docs/Web/API/SVGAElement/target
/pt-BR/docs/Web/API/Seleção	/pt-BR/docs/Web/API/Selection
/pt-BR/docs/Web/API/URL.createObjectURL	/pt-BR/docs/Web/API/URL/createObjectURl
/pt-BR/docs/Web/API/WebGL_API/Tutorial/Adicionando_conteudo_2D_a_um_contexto_WebGL	/pt-BR/docs/Web/API/WebGL_API/Tutorial/Adding_2D_content_to_a_WebGL_context
/pt-BR/docs/Web/API/WebRTC_API/Simples_RTCDataChannel_amostra	/pt-BR/docs/Web/API/WebRTC_API/Simple_RTCDataChannel_sample
/pt-BR/docs/Web/API/Web_Animations_API/Usando_a_Web_Animations_API	/pt-BR/docs/Web/API/Web_Animations_API/Using_the_Web_Animations_API
/pt-BR/docs/Web/API/Web_Storage_API_pt_br	/pt-BR/docs/Web/API/Web_Storage_API
/pt-BR/docs/Web/API/Web_Storage_API_pt_br/Using_the_Web_Storage_API	/pt-BR/docs/Web/API/Web_Storage_API/Using_the_Web_Storage_API
/pt-BR/docs/Web/API/Window.alert	/pt-BR/docs/Web/API/Window/alert
/pt-BR/docs/Web/API/Window.navigator	/pt-BR/docs/Web/API/Window/navigator
/pt-BR/docs/Web/API/Window.onscroll	/pt-BR/docs/conflicting/Web/API/GlobalEventHandlers/onscroll
/pt-BR/docs/Web/API/Window.openDialog	/pt-BR/docs/Web/API/Window/openDialog
/pt-BR/docs/Web/API/Window/URL	/pt-BR/docs/conflicting/Web/API/URL
/pt-BR/docs/Web/API/Window/Window.localStorage	/pt-BR/docs/Web/API/Window/localStorage
/pt-BR/docs/Web/API/Window/onscroll	/pt-BR/docs/conflicting/Web/API/GlobalEventHandlers/onscroll
/pt-BR/docs/Web/API/WindowBase64	/pt-BR/docs/conflicting/Web/API/WindowOrWorkerGlobalScope
/pt-BR/docs/Web/API/WindowBase64/atob	/pt-BR/docs/Web/API/WindowOrWorkerGlobalScope/atob
/pt-BR/docs/Web/API/WindowTimers	/pt-BR/docs/conflicting/Web/API/WindowOrWorkerGlobalScope_e2691f7ad05781a30c5fc5bb3b3f633a
/pt-BR/docs/Web/API/WindowTimers.clearTimeout	/pt-BR/docs/Web/API/WindowOrWorkerGlobalScope/clearTimeout
/pt-BR/docs/Web/API/WindowTimers/clearTimeout	/pt-BR/docs/Web/API/WindowOrWorkerGlobalScope/clearTimeout
/pt-BR/docs/Web/API/XMLHttpRequest/Requisicoes_sincronas_e_assincronas	/pt-BR/docs/Web/API/XMLHttpRequest/Synchronous_and_Asynchronous_Requests
/pt-BR/docs/Web/API/XMLHttpRequest/Usando_XMLHttpRequest	/pt-BR/docs/Web/API/XMLHttpRequest/Using_XMLHttpRequest
/pt-BR/docs/Web/API/document.getElementById	/pt-BR/docs/Web/API/Document/getElementById
/pt-BR/docs/Web/API/document.images	/pt-BR/docs/Web/API/Document/images
/pt-BR/docs/Web/API/document.scripts	/pt-BR/docs/Web/API/Document/scripts
/pt-BR/docs/Web/API/document.writeln	/pt-BR/docs/Web/API/Document/writeln
/pt-BR/docs/Web/API/event.type	/pt-BR/docs/Web/API/Event/type
/pt-BR/docs/Web/API/notificacoes	/pt-BR/docs/Web/API/Notification
/pt-BR/docs/Web/Accessibility/ARIA/ARIA_Techniques/Usando_o_atributo_aria-labelledby	/pt-BR/docs/Web/Accessibility/ARIA/ARIA_Techniques/Using_the_aria-labelledby_attribute
/pt-BR/docs/Web/Accessibility/ARIA/ARIA_Techniques/Usando_o_atributo_aria-required	/pt-BR/docs/Web/Accessibility/ARIA/ARIA_Techniques/Using_the_aria-required_attribute
/pt-BR/docs/Web/Accessibility/ARIA/ARIA_Techniques/Usando_o_slider_role	/pt-BR/docs/Web/Accessibility/ARIA/ARIA_Techniques/Using_the_slider_role
/pt-BR/docs/Web/Accessibility/ARIA/ARIA_Techniques/Utilizando_o_alert_role	/pt-BR/docs/Web/Accessibility/ARIA/ARIA_Techniques/Using_the_alert_role
/pt-BR/docs/Web/Accessibility/ARIA/Guia_para_implementar_o_leitor_de_tela_ARIA	/pt-BR/docs/Web/Accessibility/ARIA/ARIA_Screen_Reader_Implementors_Guide
/pt-BR/docs/Web/Accessibility/ARIA/forms/Dicas_básicas_de_form	/pt-BR/docs/Web/Accessibility/ARIA/forms/Basic_form_hints
/pt-BR/docs/Web/Accessibility/ARIA/widgets/Visão_geral	/pt-BR/docs/conflicting/Web/Accessibility/ARIA/widgets
/pt-BR/docs/Web/Acessibilidade	/pt-BR/docs/Web/Accessibility
/pt-BR/docs/Web/Acessibilidade/Accessibilidade_para_plataforma_movel	/pt-BR/docs/Web/Accessibility/Mobile_accessibility_checklist
/pt-BR/docs/Web/Acessibilidade/An_overview_of_accessible_web_applications_and_widgets	/pt-BR/docs/Web/Accessibility/An_overview_of_accessible_web_applications_and_widgets
/pt-BR/docs/Web/Acessibilidade/Desenvolvimento_Web	/pt-BR/docs/conflicting/Web/Accessibility
/pt-BR/docs/Web/Acessibilidade/Entendendo_WCAG	/pt-BR/docs/Web/Accessibility/Understanding_WCAG
/pt-BR/docs/Web/Acessibilidade/Entendendo_WCAG/Keyboard	/pt-BR/docs/Web/Accessibility/Understanding_WCAG/Keyboard
/pt-BR/docs/Web/Acessibilidade/Problemas_com_JAWS_no_Firefox	/pt-BR/docs/orphaned/Web/Accessibility/JAWS_Issues_with_Firefox
/pt-BR/docs/Web/Apps/Progressive	/pt-BR/docs/Web/Progressive_web_apps
/pt-BR/docs/Web/Apps/Progressive/Introdução	/pt-BR/docs/Web/Progressive_web_apps/Introduction
/pt-BR/docs/Web/CSS/-moz-box-ordinal-group	/pt-BR/docs/Web/CSS/box-ordinal-group
/pt-BR/docs/Web/CSS/-moz-cell	/pt-BR/docs/conflicting/Web/CSS/cursor
/pt-BR/docs/Web/CSS/CSS_Animations/Usando_animações_CSS	/pt-BR/docs/Web/CSS/CSS_Animations/Using_CSS_animations
/pt-BR/docs/Web/CSS/CSS_Background_and_Borders	/pt-BR/docs/Web/CSS/CSS_Backgrounds_and_Borders
/pt-BR/docs/Web/CSS/CSS_Background_and_Borders/Using_CSS_multiple_backgrounds	/pt-BR/docs/Web/CSS/CSS_Backgrounds_and_Borders/Using_multiple_backgrounds
/pt-BR/docs/Web/CSS/CSS_Box_Model/margin_collapsing	/pt-BR/docs/Web/CSS/CSS_Box_Model/Mastering_margin_collapsing
/pt-BR/docs/Web/CSS/CSS_Colors/seletor_de_cores	/pt-BR/docs/Web/CSS/CSS_Colors/Color_picker_tool
/pt-BR/docs/Web/CSS/CSS_Flexible_Box_Layout/Conceitos_Basicos_do_Flexbox	/pt-BR/docs/Web/CSS/CSS_Flexible_Box_Layout/Basic_Concepts_of_Flexbox
/pt-BR/docs/Web/CSS/CSS_Images/Implementando_sprites_de_imagens_em_CSS	/pt-BR/docs/Web/CSS/CSS_Images/Implementing_image_sprites_in_CSS
/pt-BR/docs/Web/CSS/CSS_Reference	/pt-BR/docs/Web/CSS/Reference
/pt-BR/docs/Web/CSS/CSS_Reference/mix-blend-mode	/pt-BR/docs/Web/CSS/mix-blend-mode
/pt-BR/docs/Web/CSS/CSS_Tipos	/pt-BR/docs/Web/CSS/CSS_Types
/pt-BR/docs/Web/CSS/Comentário	/pt-BR/docs/Web/CSS/Comments
/pt-BR/docs/Web/CSS/Elemento_substituido	/pt-BR/docs/Web/CSS/Replaced_element
/pt-BR/docs/Web/CSS/General_sibling_selectors	/pt-BR/docs/Web/CSS/General_sibling_combinator
/pt-BR/docs/Web/CSS/Getting_Started	/pt-BR/docs/conflicting/Learn/CSS/First_steps
/pt-BR/docs/Web/CSS/Getting_Started/Cascading_and_inheritance	/pt-BR/docs/conflicting/Learn/CSS/Building_blocks/Cascade_and_inheritance
/pt-BR/docs/Web/CSS/Getting_Started/Como_CSS_funciona	/pt-BR/docs/conflicting/Learn/CSS/First_steps/How_CSS_works
/pt-BR/docs/Web/CSS/Getting_Started/JavaScript	/pt-BR/docs/Learn/JavaScript/Client-side_web_APIs/Manipulating_documents
/pt-BR/docs/Web/CSS/Getting_Started/Lists	/pt-BR/docs/Learn/CSS/Styling_text/Styling_lists
/pt-BR/docs/Web/CSS/Getting_Started/Oque_&eacute;_CSS	/pt-BR/docs/conflicting/Learn/CSS/First_steps/How_CSS_works_199dae2aa1447fa94457a213c989744d
/pt-BR/docs/Web/CSS/Getting_Started/Porque_usar_CSS	/pt-BR/docs/conflicting/Learn/CSS/First_steps/How_CSS_works_61240ddc35a4ddd533ea33cc8ccf1c87
/pt-BR/docs/Web/CSS/Getting_Started/Seletores	/pt-BR/docs/conflicting/Learn/CSS/Building_blocks/Selectors
/pt-BR/docs/Web/CSS/Modelo_Visual	/pt-BR/docs/Web/CSS/Visual_formatting_model
/pt-BR/docs/Web/CSS/Modelo_layout	/pt-BR/docs/Web/CSS/Layout_mode
/pt-BR/docs/Web/CSS/Privacidade_e_o_seletor_:visited	/pt-BR/docs/Web/CSS/Privacy_and_the_:visited_selector
/pt-BR/docs/Web/CSS/Pseudo-elementos	/pt-BR/docs/Web/CSS/Pseudo-elements
/pt-BR/docs/Web/CSS/Seletor_de_atributos	/pt-BR/docs/Web/CSS/Attribute_selectors
/pt-BR/docs/Web/CSS/Seletor_universal	/pt-BR/docs/Web/CSS/Universal_selectors
/pt-BR/docs/Web/CSS/Seletores_CSS	/pt-BR/docs/Web/CSS/CSS_Selectors
/pt-BR/docs/Web/CSS/Sintexe_valor	/pt-BR/docs/Web/CSS/Value_definition_syntax
/pt-BR/docs/Web/CSS/Tools/Border-image_generator	/pt-BR/docs/Web/CSS/CSS_Background_and_Borders/Border-image_generator
/pt-BR/docs/Web/CSS/Tools/Border-radius_generator	/pt-BR/docs/Web/CSS/CSS_Background_and_Borders/Border-radius_generator
/pt-BR/docs/Web/CSS/Using_CSS_variables	/pt-BR/docs/Web/CSS/Using_CSS_custom_properties
/pt-BR/docs/Web/CSS/Valor_atual	/pt-BR/docs/Web/CSS/actual_value
/pt-BR/docs/Web/CSS/Valor_resolvido	/pt-BR/docs/Web/CSS/resolved_value
/pt-BR/docs/Web/CSS/Valor_usado	/pt-BR/docs/Web/CSS/used_value
/pt-BR/docs/Web/CSS/attr	/pt-BR/docs/Web/CSS/attr()
/pt-BR/docs/Web/CSS/box_model	/pt-BR/docs/Web/CSS/CSS_Box_Model/Introduction_to_the_CSS_box_model
/pt-BR/docs/Web/CSS/calc	/pt-BR/docs/Web/CSS/calc()
/pt-BR/docs/Web/CSS/element	/pt-BR/docs/Web/CSS/element()
/pt-BR/docs/Web/CSS/env	/pt-BR/docs/Web/CSS/env()
/pt-BR/docs/Web/CSS/filter-function/grayscale	/pt-BR/docs/Web/CSS/filter-function/grayscale()
/pt-BR/docs/Web/CSS/filter-function/opacity	/pt-BR/docs/Web/CSS/filter-function/opacity()
/pt-BR/docs/Web/CSS/filter-function/sepia	/pt-BR/docs/Web/CSS/filter-function/sepia()
/pt-BR/docs/Web/CSS/hifens	/pt-BR/docs/Web/CSS/hyphens
/pt-BR/docs/Web/CSS/image-set	/pt-BR/docs/Web/CSS/image-set()
/pt-BR/docs/Web/CSS/imagem	/pt-BR/docs/Web/CSS/image
/pt-BR/docs/Web/CSS/máscara	/pt-BR/docs/Web/CSS/mask
/pt-BR/docs/Web/CSS/radial-gradient	/pt-BR/docs/Web/CSS/radial-gradient()
/pt-BR/docs/Web/CSS/repeating-linear-gradient	/pt-BR/docs/Web/CSS/repeating-linear-gradient()
/pt-BR/docs/Web/CSS/sintaxe	/pt-BR/docs/Web/CSS/Syntax
/pt-BR/docs/Web/CSS/transform-function/matrix	/pt-BR/docs/Web/CSS/transform-function/matrix()
/pt-BR/docs/Web/CSS/transform-function/perspective	/pt-BR/docs/Web/CSS/transform-function/perspective()
/pt-BR/docs/Web/CSS/transform-function/rotate	/pt-BR/docs/Web/CSS/transform-function/rotate()
/pt-BR/docs/Web/CSS/transform-function/rotate3d	/pt-BR/docs/Web/CSS/transform-function/rotate3d()
/pt-BR/docs/Web/CSS/transform-function/scale	/pt-BR/docs/Web/CSS/transform-function/scale()
/pt-BR/docs/Web/CSS/transform-function/translate	/pt-BR/docs/Web/CSS/transform-function/translate()
/pt-BR/docs/Web/CSS/valor_computado	/pt-BR/docs/Web/CSS/computed_value
/pt-BR/docs/Web/CSS/valor_espeficifco	/pt-BR/docs/Web/CSS/specified_value
/pt-BR/docs/Web/CSS/valor_inicial	/pt-BR/docs/Web/CSS/initial_value
/pt-BR/docs/Web/CSS/var	/pt-BR/docs/Web/CSS/var()
/pt-BR/docs/Web/CSS/word-wrap	/pt-BR/docs/Web/CSS/overflow-wrap
/pt-BR/docs/Web/Events/DOMContentLoaded	/pt-BR/docs/Web/API/Window/DOMContentLoaded_event
/pt-BR/docs/Web/Events/abort	/pt-BR/docs/Web/API/HTMLMediaElement/abort_event
/pt-BR/docs/Web/Events/beforeunload	/pt-BR/docs/Web/API/Window/beforeunload_event
/pt-BR/docs/Web/Events/blur	/pt-BR/docs/Web/API/Element/blur_event
/pt-BR/docs/Web/Events/click	/pt-BR/docs/Web/API/Element/click_event
/pt-BR/docs/Web/Events/focus	/pt-BR/docs/Web/API/Element/focus_event
/pt-BR/docs/Web/Events/focusin	/pt-BR/docs/Web/API/Element/focusin_event
/pt-BR/docs/Web/Events/focusout	/pt-BR/docs/Web/API/Element/focusout_event
/pt-BR/docs/Web/Events/input	/pt-BR/docs/Web/API/HTMLElement/input_event
/pt-BR/docs/Web/Events/keydown	/pt-BR/docs/Web/API/Document/keydown_event
/pt-BR/docs/Web/Events/keypress	/pt-BR/docs/Web/API/Document/keypress_event
/pt-BR/docs/Web/Events/keyup	/pt-BR/docs/Web/API/Document/keyup_event
/pt-BR/docs/Web/Events/load	/pt-BR/docs/Web/API/Window/load_event
/pt-BR/docs/Web/Events/mousedown	/pt-BR/docs/Web/API/Element/mousedown_event
/pt-BR/docs/Web/Events/mouseenter	/pt-BR/docs/Web/API/Element/mouseenter_event
/pt-BR/docs/Web/Events/mouseover	/pt-BR/docs/Web/API/Element/mouseover_event
/pt-BR/docs/Web/Events/popstate	/pt-BR/docs/Web/API/Window/popstate_event
/pt-BR/docs/Web/Events/readystatechange	/pt-BR/docs/Web/API/Document/readystatechange_event
/pt-BR/docs/Web/Events/resize	/pt-BR/docs/Web/API/Window/resize_event
/pt-BR/docs/Web/Events/touchstart	/pt-BR/docs/Web/API/Element/touchstart_event
/pt-BR/docs/Web/Guide/CSS/CSS_Media_queries	/pt-BR/docs/Web/CSS/Media_Queries/Using_media_queries
/pt-BR/docs/Web/Guide/CSS/CSS_media_queries_(consultas_de_mídia_em_CSS)	/pt-BR/docs/orphaned/Web/Guide/CSS/CSS_media_queries_(consultas_de_mídia_em_CSS)
/pt-BR/docs/Web/Guide/CSS/Scaling_background_images	/pt-BR/docs/Web/CSS/CSS_Backgrounds_and_Borders/Resizing_background_images
/pt-BR/docs/Web/Guide/CSS/Understanding_z_index	/pt-BR/docs/Web/CSS/CSS_Positioning/Understanding_z_index
/pt-BR/docs/Web/Guide/Events/Touch_events	/pt-BR/docs/Web/API/Touch_events
/pt-BR/docs/Web/Guide/Events/criando_e_disparando_eventos	/pt-BR/docs/Web/Guide/Events/Creating_and_triggering_events
/pt-BR/docs/Web/Guide/Gráficos	/pt-BR/docs/Web/Guide/Graphics
/pt-BR/docs/Web/Guide/HTML/Canvas_tutorial	/pt-BR/docs/Web/API/Canvas_API/Tutorial
/pt-BR/docs/Web/Guide/HTML/Canvas_tutorial/Advanced_animations	/pt-BR/docs/Web/API/Canvas_API/Tutorial/Advanced_animations
/pt-BR/docs/Web/Guide/HTML/Canvas_tutorial/Applying_styles_and_colors	/pt-BR/docs/Web/API/Canvas_API/Tutorial/Applying_styles_and_colors
/pt-BR/docs/Web/Guide/HTML/Canvas_tutorial/Basic_animations	/pt-BR/docs/Web/API/Canvas_API/Tutorial/Basic_animations
/pt-BR/docs/Web/Guide/HTML/Canvas_tutorial/Compositing	/pt-BR/docs/Web/API/Canvas_API/Tutorial/Compositing
/pt-BR/docs/Web/Guide/HTML/Canvas_tutorial/Compositing/Exemplo	/pt-BR/docs/Web/API/Canvas_API/Tutorial/Compositing/Example
/pt-BR/docs/Web/Guide/HTML/Canvas_tutorial/Conclusão	/pt-BR/docs/Web/API/Canvas_API/Tutorial/Finale
/pt-BR/docs/Web/Guide/HTML/Canvas_tutorial/Drawing_shapes	/pt-BR/docs/Web/API/Canvas_API/Tutorial/Drawing_shapes
/pt-BR/docs/Web/Guide/HTML/Canvas_tutorial/Drawing_text	/pt-BR/docs/Web/API/Canvas_API/Tutorial/Drawing_text
/pt-BR/docs/Web/Guide/HTML/Canvas_tutorial/Otimizando_Canvas	/pt-BR/docs/Web/API/Canvas_API/Tutorial/Optimizing_canvas
/pt-BR/docs/Web/Guide/HTML/Canvas_tutorial/Using_images	/pt-BR/docs/Web/API/Canvas_API/Tutorial/Using_images
/pt-BR/docs/Web/Guide/HTML/Canvas_tutorial/Utilizacao_basica	/pt-BR/docs/Web/API/Canvas_API/Tutorial/Basic_usage
/pt-BR/docs/Web/Guide/HTML/Categorias_de_conteudo	/pt-BR/docs/Web/Guide/HTML/Content_categories
/pt-BR/docs/Web/Guide/HTML/Content_Editable	/pt-BR/docs/Web/Guide/HTML/Editable_content
/pt-BR/docs/Web/Guide/HTML/Forms	/pt-BR/docs/Learn/Forms
/pt-BR/docs/Web/Guide/HTML/Forms/Form_validation	/pt-BR/docs/Learn/Forms/Form_validation
/pt-BR/docs/Web/Guide/HTML/Forms/How_to_build_custom_form_widgets	/pt-BR/docs/Learn/Forms/How_to_build_custom_form_controls
/pt-BR/docs/Web/Guide/HTML/Forms/How_to_structure_an_HTML_form	/pt-BR/docs/Learn/Forms/How_to_structure_a_web_form
/pt-BR/docs/Web/Guide/HTML/Forms/Meu_primeiro_formulario_HTML	/pt-BR/docs/Learn/Forms/Your_first_form
/pt-BR/docs/Web/Guide/HTML/Forms/Os_widgets_nativos	/pt-BR/docs/Learn/Forms/Basic_native_form_controls
/pt-BR/docs/Web/Guide/HTML/Forms/Sending_and_retrieving_form_data	/pt-BR/docs/Learn/Forms/Sending_and_retrieving_form_data
/pt-BR/docs/Web/Guide/HTML/Using_data_attributes	/pt-BR/docs/Learn/HTML/Howto/Use_data_attributes
/pt-BR/docs/Web/Guide/Introducao_ao_Desenvolvimento_Web	/pt-BR/docs/Web/Guide/Introduction_to_Web_development
/pt-BR/docs/Web/HTML/CORS_imagens_habilitadas	/pt-BR/docs/Web/HTML/CORS_enabled_image
/pt-BR/docs/Web/HTML/Canvas	/pt-BR/docs/Web/API/Canvas_API
/pt-BR/docs/Web/HTML/Canvas/A_basic_ray-caster	/pt-BR/docs/Web/API/Canvas_API/A_basic_ray-caster
/pt-BR/docs/Web/HTML/Controlando_verificacao_ortografica_em_formularios_HTML	/pt-BR/docs/Web/HTML/Global_attributes/spellcheck
/pt-BR/docs/Web/HTML/Dicas_para_criar_páginas_HTML_de_carregamento_rápido	/pt-BR/docs/Learn/HTML/Howto/Author_fast-loading_HTML_pages
/pt-BR/docs/Web/HTML/Element/Input/data	/pt-BR/docs/Web/HTML/Element/input/date
/pt-BR/docs/Web/HTML/Element/command	/pt-BR/docs/orphaned/Web/HTML/Element/command
/pt-BR/docs/Web/HTML/Element/conteúdo	/pt-BR/docs/Web/HTML/Element/content
/pt-BR/docs/Web/HTML/Element/figura	/pt-BR/docs/Web/HTML/Element/figure
/pt-BR/docs/Web/HTML/Elementos_block-level	/pt-BR/docs/Web/HTML/Block-level_elements
/pt-BR/docs/Web/HTML/Elementos_nlock-level	/pt-BR/docs/Web/HTML/Block-level_elements
/pt-BR/docs/Web/HTML/HTML5	/pt-BR/docs/Web/Guide/HTML/HTML5
/pt-BR/docs/Web/HTML/HTML5/HTML5_element_list	/pt-BR/docs/Web/HTML/Element
/pt-BR/docs/Web/HTML/HTML5/Introduction_to_HTML5	/pt-BR/docs/Web/Guide/HTML/HTML5/Introduction_to_HTML5
/pt-BR/docs/Web/HTML/Inline_elemente	/pt-BR/docs/Web/HTML/Inline_elements
/pt-BR/docs/Web/HTML/Optimizing_your_pages_for_speculative_parsing	/pt-BR/docs/Glossary/speculative_parsing
/pt-BR/docs/Web/HTML/ReferenciaHTML	/pt-BR/docs/Web/HTML/Reference
/pt-BR/docs/Web/HTML/Using_HTML5_audio_and_video	/pt-BR/docs/conflicting/Learn/HTML/Multimedia_and_embedding/Video_and_audio_content
/pt-BR/docs/Web/HTML/favicon	/pt-BR/docs/orphaned/Web/HTML/favicon
/pt-BR/docs/Web/HTML/formatos_midia_suportados	/pt-BR/docs/Web/Media/Formats
/pt-BR/docs/Web/HTML/microformatos	/pt-BR/docs/Web/HTML/microformats
/pt-BR/docs/Web/HTTP/Basico_sobre_HTTP	/pt-BR/docs/Web/HTTP/Basics_of_HTTP
/pt-BR/docs/Web/HTTP/Basico_sobre_HTTP/Identifying_resources_on_the_Web	/pt-BR/docs/Web/HTTP/Basics_of_HTTP/Identifying_resources_on_the_Web
/pt-BR/docs/Web/HTTP/Basico_sobre_HTTP/MIME_types	/pt-BR/docs/Web/HTTP/Basics_of_HTTP/MIME_types
/pt-BR/docs/Web/HTTP/Basico_sobre_HTTP/MIME_types/Complete_list_of_MIME_types	/pt-BR/docs/Web/HTTP/Basics_of_HTTP/MIME_types/Common_types
/pt-BR/docs/Web/HTTP/Cabecalhos_HTTP	/pt-BR/docs/Web/HTTP/Headers
/pt-BR/docs/Web/HTTP/Compressão	/pt-BR/docs/Web/HTTP/Compression
/pt-BR/docs/Web/HTTP/Controle_Acesso_CORS	/pt-BR/docs/Web/HTTP/CORS
/pt-BR/docs/Web/HTTP/Gerenciamento_de_Conexão_em_HTTP_1.x	/pt-BR/docs/Web/HTTP/Connection_management_in_HTTP_1.x
/pt-BR/docs/Web/HTTP/HTTP	/pt-BR/docs/Web/HTTP/Caching
/pt-BR/docs/Web/HTTP/Headers/Conexão	/pt-BR/docs/Web/HTTP/Headers/Connection
/pt-BR/docs/Web/HTTP/Headers/Expira	/pt-BR/docs/Web/HTTP/Headers/Expires
/pt-BR/docs/Web/HTTP/Headers/Localização	/pt-BR/docs/Web/HTTP/Headers/Location
/pt-BR/docs/Web/HTTP/Mensagens	/pt-BR/docs/Web/HTTP/Messages
/pt-BR/docs/Web/HTTP/Redirecionamento	/pt-BR/docs/Web/HTTP/Redirections
/pt-BR/docs/Web/HTTP/Server-Side_Access_Control	/pt-BR/docs/conflicting/Web/HTTP/CORS
/pt-BR/docs/Web/JavaScript/Enumerabilidade_e_posse_de_propriedades	/pt-BR/docs/Web/JavaScript/Enumerability_and_ownership_of_properties
/pt-BR/docs/Web/JavaScript/Guide/About	/pt-BR/docs/Web/JavaScript/Guide/Introduction
/pt-BR/docs/Web/JavaScript/Guide/Closures	/pt-BR/docs/Web/JavaScript/Closures
/pt-BR/docs/Web/JavaScript/Guide/Coleções_chaveadas	/pt-BR/docs/orphaned/Web/JavaScript/Guide/Coleções_chaveadas
/pt-BR/docs/Web/JavaScript/Guide/Declarações	/pt-BR/docs/Web/JavaScript/Guide/Control_flow_and_error_handling
/pt-BR/docs/Web/JavaScript/Guide/Detalhes_do_Modelo_do_Objeto	/pt-BR/docs/Web/JavaScript/Guide/Details_of_the_Object_Model
/pt-BR/docs/Web/JavaScript/Guide/Formatando_texto	/pt-BR/docs/Web/JavaScript/Guide/Text_formatting
/pt-BR/docs/Web/JavaScript/Guide/Funções	/pt-BR/docs/Web/JavaScript/Guide/Functions
/pt-BR/docs/Web/JavaScript/Guide/Igualdade	/pt-BR/docs/conflicting/Web/JavaScript/Equality_comparisons_and_sameness
/pt-BR/docs/Web/JavaScript/Guide/Inheritance_Revisited	/pt-BR/docs/Web/JavaScript/Inheritance_and_the_prototype_chain
/pt-BR/docs/Web/JavaScript/Guide/Inheritance_and_the_prototype_chain	/pt-BR/docs/Web/JavaScript/Inheritance_and_the_prototype_chain
/pt-BR/docs/Web/JavaScript/Guide/Iteratores_e_geradores	/pt-BR/docs/Web/JavaScript/Guide/Iterators_and_Generators
/pt-BR/docs/Web/JavaScript/Guide/JavaScript_Visão_Geral	/pt-BR/docs/Web/JavaScript/Guide/Introduction
/pt-BR/docs/Web/JavaScript/Guide/Lacos_e_iteracoes	/pt-BR/docs/Web/JavaScript/Guide/Loops_and_iteration
/pt-BR/docs/Web/JavaScript/Guide/Módulos	/pt-BR/docs/Web/JavaScript/Guide/Modules
/pt-BR/docs/Web/JavaScript/Guide/Numeros_e_datas	/pt-BR/docs/Web/JavaScript/Guide/Numbers_and_dates
/pt-BR/docs/Web/JavaScript/Guide/Sintaxe_e_tipos	/pt-BR/docs/orphaned/Web/JavaScript/Guide/Sintaxe_e_tipos
/pt-BR/docs/Web/JavaScript/Guide/Trabalhando_com_Objetos	/pt-BR/docs/Web/JavaScript/Guide/Working_with_Objects
/pt-BR/docs/Web/JavaScript/Guide/Usando_promises	/pt-BR/docs/Web/JavaScript/Guide/Using_promises
/pt-BR/docs/Web/JavaScript/Guide/Values,_variables,_and_literals	/pt-BR/docs/Web/JavaScript/Guide/Grammar_and_types
/pt-BR/docs/Web/JavaScript/Introduction_to_Object-Oriented_JavaScript	/pt-BR/docs/conflicting/Learn/JavaScript/Objects
/pt-BR/docs/Web/JavaScript/Outras_ferramentas_JavaScript	/pt-BR/docs/Tools
/pt-BR/docs/Web/JavaScript/Reference/Errors/Fata_parênteses_após_lista_argumento	/pt-BR/docs/Web/JavaScript/Reference/Errors/Missing_parenthesis_after_argument_list
/pt-BR/docs/Web/JavaScript/Reference/Errors/Fecha_chaves_esquecida_apos_lista_propriedades	/pt-BR/docs/Web/JavaScript/Reference/Errors/Missing_curly_after_property_list
/pt-BR/docs/Web/JavaScript/Reference/Errors/NãoNomeado_funcão_declaração	/pt-BR/docs/Web/JavaScript/Reference/Errors/Unnamed_function_statement
/pt-BR/docs/Web/JavaScript/Reference/Errors/Não_definido	/pt-BR/docs/Web/JavaScript/Reference/Errors/Not_defined
/pt-BR/docs/Web/JavaScript/Reference/Functions/Definicoes_metodos	/pt-BR/docs/Web/JavaScript/Reference/Functions/Method_definitions
/pt-BR/docs/Web/JavaScript/Reference/Functions/Parametros_Predefinidos	/pt-BR/docs/Web/JavaScript/Reference/Functions/Default_parameters
/pt-BR/docs/Web/JavaScript/Reference/Global_Objects/Array/contains	/pt-BR/docs/Web/JavaScript/Reference/Global_Objects/Array/includes
/pt-BR/docs/Web/JavaScript/Reference/Global_Objects/Array/filtro	/pt-BR/docs/Web/JavaScript/Reference/Global_Objects/Array/filter
/pt-BR/docs/Web/JavaScript/Reference/Global_Objects/Array/prototype	/pt-BR/docs/orphaned/Web/JavaScript/Reference/Global_Objects/Array/prototype
/pt-BR/docs/Web/JavaScript/Reference/Global_Objects/BigInt/prototype	/pt-BR/docs/orphaned/Web/JavaScript/Reference/Global_Objects/BigInt/prototype
/pt-BR/docs/Web/JavaScript/Reference/Global_Objects/Boolean/prototype	/pt-BR/docs/conflicting/Web/JavaScript/Reference/Global_Objects/Boolean
/pt-BR/docs/Web/JavaScript/Reference/Global_Objects/Function/prototype	/pt-BR/docs/conflicting/Web/JavaScript/Reference/Global_Objects/Function
/pt-BR/docs/Web/JavaScript/Reference/Global_Objects/Intl/NumberFormat/prototype	/pt-BR/docs/conflicting/Web/JavaScript/Reference/Global_Objects/Intl/NumberFormat
/pt-BR/docs/Web/JavaScript/Reference/Global_Objects/Map/prototype	/pt-BR/docs/conflicting/Web/JavaScript/Reference/Global_Objects/Map
/pt-BR/docs/Web/JavaScript/Reference/Global_Objects/Number/prototype	/pt-BR/docs/conflicting/Web/JavaScript/Reference/Global_Objects/Number
/pt-BR/docs/Web/JavaScript/Reference/Global_Objects/NumberFormat	/pt-BR/docs/Web/JavaScript/Reference/Global_Objects/Intl/NumberFormat
/pt-BR/docs/Web/JavaScript/Reference/Global_Objects/NumberFormat/prototype	/pt-BR/docs/conflicting/Web/JavaScript/Reference/Global_Objects/Intl/NumberFormat
/pt-BR/docs/Web/JavaScript/Reference/Global_Objects/Object/prototype	/pt-BR/docs/conflicting/Web/JavaScript/Reference/Global_Objects/Object
/pt-BR/docs/Web/JavaScript/Reference/Global_Objects/Promise/prototype	/pt-BR/docs/conflicting/Web/JavaScript/Reference/Global_Objects/Promise
/pt-BR/docs/Web/JavaScript/Reference/Global_Objects/RelativeTimeFormat	/pt-BR/docs/Web/JavaScript/Reference/Global_Objects/Intl/RelativeTimeFormat
/pt-BR/docs/Web/JavaScript/Reference/Global_Objects/Set/prototype	/pt-BR/docs/conflicting/Web/JavaScript/Reference/Global_Objects/Set
/pt-BR/docs/Web/JavaScript/Reference/Global_Objects/String/prototype	/pt-BR/docs/conflicting/Web/JavaScript/Reference/Global_Objects/String
/pt-BR/docs/Web/JavaScript/Reference/Global_Objects/WeakMap/prototype	/pt-BR/docs/conflicting/Web/JavaScript/Reference/Global_Objects/WeakMap
/pt-BR/docs/Web/JavaScript/Reference/Indice_metodos_js	/pt-BR/docs/Web/JavaScript/Reference
/pt-BR/docs/Web/JavaScript/Reference/Operators/Arithmetic_Operators	/pt-BR/docs/conflicting/Web/JavaScript/Reference/Operators
/pt-BR/docs/Web/JavaScript/Reference/Operators/Atribuicao_via_desestruturacao	/pt-BR/docs/Web/JavaScript/Reference/Operators/Destructuring_assignment
/pt-BR/docs/Web/JavaScript/Reference/Operators/Bitwise_Operators	/pt-BR/docs/conflicting/Web/JavaScript/Reference/Operators_7c8eb9475d97a4a734c5991857698560
/pt-BR/docs/Web/JavaScript/Reference/Operators/Inicializador_Objeto	/pt-BR/docs/Web/JavaScript/Reference/Operators/Object_initializer
/pt-BR/docs/Web/JavaScript/Reference/Operators/Operador_Condicional	/pt-BR/docs/Web/JavaScript/Reference/Operators/Conditional_Operator
/pt-BR/docs/Web/JavaScript/Reference/Operators/Operador_Virgula	/pt-BR/docs/Web/JavaScript/Reference/Operators/Comma_Operator
/pt-BR/docs/Web/JavaScript/Reference/Operators/Operadores_Logicos	/pt-BR/docs/conflicting/Web/JavaScript/Reference/Operators_8fa8b34b0547a749514637a15d386886
/pt-BR/docs/Web/JavaScript/Reference/Operators/Operadores_de_comparação	/pt-BR/docs/conflicting/Web/JavaScript/Reference/Operators_0d2e4b8154642b5a9dbd76a2a48cf96a
/pt-BR/docs/Web/JavaScript/Reference/Operators/Spread_operator	/pt-BR/docs/conflicting/Web/JavaScript/Reference/Operators/Spread_syntax
/pt-BR/docs/Web/JavaScript/Reference/Operators/operador_de_coalescencia_nula	/pt-BR/docs/Web/JavaScript/Reference/Operators/Nullish_coalescing_operator
/pt-BR/docs/Web/JavaScript/Reference/Properties_Index	/pt-BR/docs/Web/JavaScript/Reference
/pt-BR/docs/Web/JavaScript/Reference/Statements/default	/pt-BR/docs/conflicting/Web/JavaScript/Reference/Statements/switch
/pt-BR/docs/Web/JavaScript/Reference/Statements/funcoes_assincronas	/pt-BR/docs/Web/JavaScript/Reference/Statements/async_function
/pt-BR/docs/Web/JavaScript/Reference/template_strings	/pt-BR/docs/Web/JavaScript/Reference/Template_literals
/pt-BR/docs/Web/MathML/Exemplos	/pt-BR/docs/Web/MathML/Examples
/pt-BR/docs/Web/Performance/caminho_de_renderizacao_critico	/pt-BR/docs/Web/Performance/Critical_rendering_path
/pt-BR/docs/Web/Progressive_web_apps/Introdução	/pt-BR/docs/Web/Progressive_web_apps/Introduction
/pt-BR/docs/Web/SVG/Element/texto	/pt-BR/docs/Web/SVG/Element/text
/pt-BR/docs/Web/SVG/Intensivo_de_Namespaces	/pt-BR/docs/Web/SVG/Namespaces_Crash_Course
/pt-BR/docs/Web/Security/Básico_de_Segurança_da_Informação	/pt-BR/docs/orphaned/Web/Security/Information_Security_Basics
/pt-BR/docs/Web/Tutoriais	/pt-BR/docs/Web/Tutorials
/pt-BR/docs/Web/WebGL	/pt-BR/docs/Web/API/WebGL_API
/pt-BR/docs/Web/Web_Components/Usando_custom_elements	/pt-BR/docs/Web/Web_Components/Using_custom_elements
/pt-BR/docs/WebAPI	/pt-BR/docs/conflicting/Web/API_dd04ca1265cb79b990b8120e5f5070d3
/pt-BR/docs/WebAPI/Battery_Status	/pt-BR/docs/Web/API/Battery_Status_API
/pt-BR/docs/WebAPI/Network_Information	/pt-BR/docs/Web/API/Network_Information_API
/pt-BR/docs/WebAssembly/Entendendo_o_formato_textual_do_WebAssembly	/pt-BR/docs/WebAssembly/Understanding_the_text_format
/pt-BR/docs/WebAssembly/Usando_a_API_JavaScript_do_WebAssembly	/pt-BR/docs/WebAssembly/Using_the_JavaScript_API
/pt-BR/docs/WebGL	/pt-BR/docs/Web/API/WebGL_API
/pt-BR/docs/WebRTC	/pt-BR/docs/conflicting/Web/API/WebRTC_API
/pt-BR/docs/WebRTC/navigator.getUserMedia	/pt-BR/docs/Web/API/Navigator/getUserMedia
/pt-BR/docs/WebSockets	/pt-BR/docs/Web/API/WebSockets_API
/pt-BR/docs/WebSockets/Escrevendo_aplicacoes_cliente_WebSocket	/pt-BR/docs/Web/API/WebSockets_API/Writing_WebSocket_client_applications
/pt-BR/docs/WebSockets/Writing_WebSocket_server	/pt-BR/docs/Web/API/WebSockets_API/Writing_WebSocket_server
/pt-BR/docs/WebSockets/Writing_WebSocket_servers	/pt-BR/docs/Web/API/WebSockets_API/Writing_WebSocket_servers
/pt-BR/docs/Web_Development/Mobile	/pt-BR/docs/conflicting/Web/Guide/Mobile
/pt-BR/docs/Web_Development/Mobile/Design_responsivo	/pt-BR/docs/conflicting/Web/Progressive_web_apps
/pt-BR/docs/Web_Development/Mobile/Mobile-friendliness	/pt-BR/docs/Web/Guide/Mobile/Mobile-friendliness
/pt-BR/docs/Web_Development/Mobile/Sites_separados	/pt-BR/docs/Web/Guide/Mobile/Separate_sites
/pt-BR/docs/XHTML	/pt-BR/docs/Glossary/XHTML
/pt-BR/docs/c_temp	/pt-BR/docs/Web/API/Console
/pt-BR/docs/desenvolvimento_web	/pt-BR/docs/conflicting/Web/Guide
/pt-BR/docs/dez_anos_de_MDN	/pt-BR/docs/MDN/At_ten
/pt-BR/docs/en	/en-US/
/pt-BR/docs/mask	/pt-BR/docs/Web/CSS/mask
